S----SSSSSSSSSSSSSSSSSSSSSSSSSSSSSSSSSSSSSSSSSSSSSSSSSSSSSSSSSSSSSSSSSSSSSSSSSSSSSSSSSSSSSSSSSSSSSSSSSSSSSSSSSSSSSSSSSSSSSSSSSSSSSSSSSSSSSSSSSSSSSSSSS
S----------SSSSSSSSSSSSSSSSSSSSSSSSSSSSSSSSSSSSSSSSSSSSSSSSSSSSSSSSS--------SSSSSSSSSSSSSSSSSSSSSSSSSSSSS------------SSSSSSSSSSSSSSSSSSSSSSS----------
S----------SSSSSSSSSSSS------SSSSSSSSSSSSSSSSSSSSSS-----------SSSSSS--------SSSSSSSS--------------SSSSSSS------------SSSSSSSS-------SSSSSSSS----------
S----------SSSSSSSSSSSS--------------SSSSSSS------------------SSSSSS------------------------------SSSSSSS---------------------------------------------
S-----------------------------------------------------------------------------------------------------------------------------------------------------
S-----------------------------------------------------------------------------------------------------------------------------------------------------
S-----------------------------------------------------------------------------------------------------------------------------------------------------
S-----------------------------------------------------------------------------------------------------------------------------------------------------
S-----------------------------------------------------------------------------------------------------------------------------------------------------
S----------------------------------oooo-------------------------ooooSS--------------------------------------------------------------------------------
S-----------------------------------------------------------------------------oSooS---------oooSo---ooooo---------------------------tt----tt------ooo-
S----------------------------------oooo-------------ooSo----------ooooooo-----------------------------------------------------------tt----tt----------
S------------------------------------------XX----------------XX-------------ooooooo---------ooo---XXXXXXXXX-----XXXXXXX-------------tt----tt----------
S-----------XXXXX--Tt----XXXXXXXXXXXXXXXXXXXXXXXXX---oo--XXXXXXXXXXXXXXXXX------------------------XXXXXXXXX--XXXXXXXXXX------XXXXXXXXXXXXXXXXXXX------
SXXXXXXXXXXXXXXXX--Tt----XXXXXXXXXXXXXXXXXXXXXXXXX-------XXXXXXXXXXXXXXXXXXXXXXXXXXXXXXXXXXXXXXXXXXXXXXXXXX--XXXXXXXXXX------XXXXXXXXXXXXXXXXXXXXXXXXX
SXXXXXXXXXXXXXXXXXXXXXXXXXXXXXXXXXXXXXXXXXXXXXXXXXXXXXXXXXXXXXXXXXXXXXXXXXXXXXXXXXXXXXXXXXXXXXXXXXXXXXXXXXXXXXXXXXXXXXXXXXXXXXXXXXXXXXXXXXXXXXXXXXXXXX

