S----SSSSSSSSSSSSSSSSSSSSSSSSSSSSSSSSSSSSSSSSSSSSSSSSSSSSSSSSSSSSSSSSSSSSSSSSSSSSSSSSSSSSSSSSSSSSSSSSSSSSSSSSSSSSSSSSSSSSSSSSSSSSSSSSSSSSSSSSSSSSSSSSS
S----SSSSSSS-------------SSSSSSSS--------SSSSSSSSSSSSSSSSSSSSSSSSSSSSSSSSSSSSSSSSSSSSSSSSSSSSSSSSSSSSSSSSSSSSSSSSSSSSSSSSSSSSSSSSSSSSSSSSSSSSSSSSSSSSS
S---------------------------------------------SSSSS------SSSSSSSSSSSSSSSS-------------SSSSS-----SSSSSS--------------SSSSSS------SSSSSSSSSSS------SSSSS
S-------------------------------------------------------------------------------------------------------------------------------SSSSSSSSSSS-----------
S-----------------------------------------------------------------------------------------------------------------------------------------------------
S-----------------------------------------------------------------------------------------------------------------------------------------------------
S-----------------------------------------------------------------------------------------------------------------------------------------------------
S-----------------------------------------------------------------------------------------------------------------------------------------------------
S--------------------------------------------------------------------------------------------------SSSo-----------------------------------------ooo---
S------------------------------Soo--------------------------------------------------------------------------------------------------------------------
S-------------------SSSoo--------------------------------------------------------------------------oo-------------------Sooooo------ooSo-------ooo----
S-----------ooo--------------oo------------Soo----oooo-------ooo--------oSoooS---ooSo-----oSo---------------------------------------------------------
SXXXXXXXXX-------ooooooooo-------g--------------------------------------------------------------XXXXXXXX-----XXXXXXXXX--oooo---XXXX---ooo-----XXXXXXXX
SXXXXXXXXX-----------------XXXXXXXX--XXXX--------XXXXXXX---ooooo----------ooo-----oo-----ooooo--XXXXXXXX-----XXXXXXXXX---------XXXX---------XXXXXXXXXX
SXXXXXXXXX------XXXXXXXXXXXXXXXXXXX--XXXX--------XXXXXXXXX-------g------------------------------XXXXXXXX-----XXXXXXXXXXXXXXXXXXXXXXXXXXXXXXXXXXXXXXXXX
SXXXXXXXXXXXXXXXXXXXXXXXXXXXXXXXXXXXXXXXXXXXXXXXXXXXXXXXXXXXXXXXXXXXXXXXXXXXXXXXXXXXXXXXXXXXXXXXXXXXXXXXXXXXXXXXXXXXXXXXXXXXXXXXXXXXXXXXXXXXXXXXXXXXXX

