S----SSSSSSSSSSSSSSSSSSSSSSSSSSSSSSSSSSSSSSSSSSSSSSSSSSSSSSSSSSSSSSSSSSSSSSSSSSSSSSSSSSSSSSSSSSSSSSSSSSSSSSSSSSSSSSSSSSSSSSSSSSSSSSSSSSSSSSSSSSSSSSSSS
S----SSSSSSSSSSSSSSSSSSSSSSSSSSSSSSSSSSSSSSSSSSSSSSSSSSSSSSSSSSSSSSSSSS-------------SSSSSSSSSSSSSSSSSS-------------------SSSSSSSSSSSSSSSSSS-------SSSS
S----SSSSSSSSSSSSSSSS--------------SSSSSSSS----------------------SSSSSS-------------SSSSSSSSSSSSSSSSSS-------------------SSSSSSSSSSSSSSSSSS-----------
S----SSSSSSSSSS--------------------SSSSSSSS-----------------------------------------SSSSSSSSSSSSS------------------------SSSSSS-----------------------
S-----------------------------------------------------------------------------------------------------------------------------------------------------
S-----------------------------------------------------------------------------------------------------------------------------------------------------
S-----------------------------------------------------------------------------------------------------------------------------------------------------
S-----------------------------------------------------------------------------------------------------------------------------------------------------
S-----------------------------------------------------------------------------------------oooooo-----------------oSooSo-------------------ooo---------
S----------------------------ooo-----------------------------oSoo------------ooooo--------------------------------------------------------------------
S--------------oooo-----------------------------------ooo-------------------------------ooooooo-----------oSo-----oooo------------------oooo----------
S--------------------------ooooo-----g--------Soooo-----------ooo-----------ooooo----------g----------------------------------------------------------
S----------------oo---XXX-----------XXXXXX-------------ooo-----------------------------XXXXXXXXXX-------------XXXXXXXXXX----XXXXXX----XXXXXXXXXX--XXXX
S-------------------g-XXXXXXXXXXXXXXXXXXXX----oo------------XXXXXXXXXXXXX--XXXXXXXXXX--XXXXXXXXXX-------------XXXXXXXXXX----XXXXXX----XXXXXXXXXXXXXXXX
S-------------XXXXXXXXXXXXXXXXXXXXXXXXXXXX--------g-XXXXXXXXXXXXXXXXXXXXXXXXXXXXXXXXX--XXXXXXXXXXXXXXXXXXXXXXXXXXXXXXXXXXXXXXXXXXXXXXXXXXXXXXXXXXXXXXX
SXXXXXXXXXXXXXXXXXXXXXXXXXXXXXXXXXXXXXXXXXXXXXXXXXXXXXXXXXXXXXXXXXXXXXXXXXXXXXXXXXXXXXXXXXXXXXXXXXXXXXXXXXXXXXXXXXXXXXXXXXXXXXXXXXXXXXXXXXXXXXXXXXXXXX

