S----SSSSSSSSSSSSSSSSSSSSSSSSSSSSSSSSSSSSSSSSSSSSSSSSSSSSSSSSSSSSSSSSSSSSSSSSSSSSSSSSSSSSSSSSSSSSSSSSSSSSSSSSSSSSSSSSSSSSSSSSSSSSSSSSSSSSSSSSSSSSSSSSS
S----SSSSSSSSSSSSSSSSSSSSSSSSSSSSSSS-------SSSSSSSSSSSSSSS------SSSSSSSS-----SSSSSSSSSSSSSSSSSSSSSSSSSSSSSSSSSSSSSSSSSSSSSSSSSSSSSSSSS--------SSSSSSSS
S----SSSSSSSSSSSSSSS--------SSSSSSSS-------SSSSSSSSSSSSSSS------------------------SSSSSSSSSSSSSSSSSSSSSSSSSSSSSSSSSSS-------------------------SSSSSSSS
S----SSSSSSSSSSSSSSS--------SSSSSSSS-------SSSSSSSS-------------------------------SSSSSSSSSSSSS--------------SSSSSSSS-------------------------------SS
S-----------------------------------------------------------------------------------------------------------------------------------------------------
S-----------------------------------------------------------------------------------------------------------------------------------------------------
S-----------------------------------------------------------------------------------------------------------------------------------------------------
S-----------------------------------------------------------------------------------------------------------------------------------------------------
S----------------------------------------------------------ooSo---------------oSSoS------------------------ooSS---------------------------------------
S-------------------------ooooSooS-----------------------------------------------------------------------------------------------------ooSo-----------
S----------------------------------------------------------oooo----------------oooooo------------------------oo---------------------------------------
S----------------------------oooo-------------ooooSS-----------------------------------ooSo----------------g------------oo----------------------------
S-------------------XX---------------------------------XXXXXXXXXXXXX---XXXXXXXXXXXXXXX------XXXXX--------XXXXXXXXXXXXXX--------ooooo-----g-----tt-tt--
S-------------------XX---XXXXXXXXXXXXXX--------oooooo--XXXXXXXXXXXXX---XXXXXXXXXXXXXXX------XXXXX--------XXXXXXXXXXXXXXXXXXXXX--------XXXXXX---tt-tt--
SXXXXXXXXXXXXX------XX---XXXXXXXXXXXXXX----------------XXXXXXXXXXXXXXXXXXXXXXXXXXXXXXX------XXXXX--------XXXXXXXXXXXXXXXXXXXXXXXXXXXXXXXXXXXXX-tt-tt--
SXXXXXXXXXXXXXXXXXXXXXXXXXXXXXXXXXXXXXXXXXXXXXXXXXXXXXXXXXXXXXXXXXXXXXXXXXXXXXXXXXXXXXXXXXXXXXXXXXXXXXXXXXXXXXXXXXXXXXXXXXXXXXXXXXXXXXXXXXXXXXXXXXXXXX

