S----SSSSSSSSSSSSSSSSSSSSSSSSSSSSSSSSSSSSSSSSSSSSSSSSSSSSSSSSSSSSSSSSSSSSSSSSSSSSSSSSSSSSSSSSSSSSSSSSSSSSSSSSSSSSSSSSSSSSSSSSSSSSSSSSSSSSSSSSSSSSSSSSS
S----------SSSSSSS-------------SSSSSSSSSSSSSSSSSSS-------SSSSSSSSSSSSSSSSSSSSSSSSS--------------SSSSSSSSSSSSSSSSSSSSSSSSSSSSSSSSSSSSSSSSSSSSSSSSSSSSSS
S----------SSSSSSS-------------SSSSSS-------SSSSSS-------SSSSSSSSSSS------SSSSSSSS--------------SSSSSSSSSSSSSSSSSSSSSSSSSSSSSSSSSSSSSSSSSSSSSSSSSSSSS-
S-------------------------------------------SSSSSS-------------SSSSS------SSSSSSSS---------------------SSSSSSSSSSSSSSS-----SSSSSSS--------------SSSSS-
S-----------------------------------------------------------------------------------------------------------------------------------------------------
S-----------------------------------------------------------------------------------------------------------------------------------------------------
S-----------------------------------------------------------------------------------------------------------------------------------------------------
S-----------------------------------------------------------------------------------------------------------------------------------------------------
S------------------------------oSSS------------------------------------------------------------ooSoo----------------------------------------oSoooo----
S-----------------------------------------------------------------------------------------------------------------------------------------------------
S-----------------------------ooo----------------------------------oSooS----ooS--------------ooooo-------------------------------------------oooooo---
S--------------------------------------ooo-----oooooSo---------------------------------oSoo-----g-----------------ooSS----------oooSSSo---------------
S-------------XXXXXX---------XXXXXXXX-----------------------------oooooo-----ooo---XX-------XXXXXXXXXXX----------------------------------XXXXXXXXXXXXX
S-------------XXXXXX----XXXXXXXXXXXXXXXXXXXXXX-oooooooo--oo------------------------XX---oo--XXXXXXXXXXX--------ooooooo-----------ooooo---XXXXXXXXXXXXX
S-------------XXXXXXXXXXXXXXXXXXXXXXXXXXXXXXXX-----------------XXXXXXXXXXXXXXXXXXXXXX-------XXXXXXXXXXX----------------------------------XXXXXXXXXXXXX
SXXXXXXXXXXXXXXXXXXXXXXXXXXXXXXXXXXXXXXXXXXXXXXXXXXXXXXXXXXXXXXXXXXXXXXXXXXXXXXXXXXXXXXXXXXXXXXXXXXXXXXXXXXXXXXXXXXXXXXXXXXXXXXXXXXXXXXXXXXXXXXXXXXXXX

