S----SSSSSSSSSSSSSSSSSSSSSSSSSSSSSSSSSSSSSSSSSSSSSSSSSSSSSSSSSSSSSSSSSSSSSSSSSSSSSSSSSSSSSSSSSSSSSSSSSSSSSSSSSSSSSSSSSSSSSSSSSSSSSSSSSSSSSSSSSSSSSSSSS
S-----------SSSSSSSSSSSSSSSSSS-------SSSSSSSSSSSSSSSSSSS------SSSSSSSS------SSSSSSSSSSSSSS-----SSSSSSSSSSSSSSSSSSSSSSS-----SSSSSSSSSSSSS-------SSSSSSS
S-----------SSSSSSSSSSSSSSSSSS-------------SSSSS--------------SSSSSSSS------SSSSSSSS-------------------SSSSSSSS--------------------------------SSSSSS-
S----------------SSSSSSSS-------------------------------------SSSSSSSS------SSSSSSSS-------------------SSSSSSSS---------------------------------------
S-----------------------------------------------------------------------------------------------------------------------------------------------------
S-----------------------------------------------------------------------------------------------------------------------------------------------------
S-----------------------------------------------------------------------------------------------------------------------------------------------------
S-----------------------------------------------------------------------------------------------------------------------------------------------------
S------------------------------------------------------------------------------------------------------ooooooo----------------------------------------
S-----------------------------------------------------------------------------------------------------------------------------ooSoSo------------------
S----------------------------oooo----ooo-----------ooo--------------------------------------------------oooo-----------------------------oooS---------
S--------------oo-----Soo-------------------oSo-----g---------------ooooS-------ooo--------------------------------SSooo-------oooo-------------------
SXXXXXXXXXXXXX--------------XXXXXXXXXXXXXX-------XXXXXX----XX---------------XX----------ooooo---------XXXXXXXXX------------------------ooooo----XXXXXX
SXXXXXXXXXXXXXXXXXXX--------XXXXXXXXXXXXXX-------XXXXXX----XX-------oooooo--XX---oooo------------XX---XXXXXXXXX---oooo-------XXXXXXXX--------g--XXXXXX
SXXXXXXXXXXXXXXXXXXX--------XXXXXXXXXXXXXX-------XXXXXX----XX--XXX----g-----XX---------XXXXXXX---XXXXXXXXXXXXXX--------------XXXXXXXXXXXXXXXXXXXXXXXXX
SXXXXXXXXXXXXXXXXXXXXXXXXXXXXXXXXXXXXXXXXXXXXXXXXXXXXXXXXXXXXXXXXXXXXXXXXXXXXXXXXXXXXXXXXXXXXXXXXXXXXXXXXXXXXXXXXXXXXXXXXXXXXXXXXXXXXXXXXXXXXXXXXXXXXX

