S----SSSSSSSSSSSSSSSSSSSSSSSSSSSSSSSSSSSSSSSSSSSSSSSSSSSSSSSSSSSSSSSSSSSSSSSSSSSSSSSSSSSSSSSSSSSSSSSSSSSSSSSSSSSSSSSSSSSSSSSSSSSSSSSSSSSSSSSSSSSSSSSSS
S----SSSSSSSSSSSSSSSSSSSSSSS-------SSSSSSSSSSSSS-----SSSSSSSSSSSSSSSSSSSSSSSSSSSSSSSSSSSSSSSSSSSSSSSSSSSSSSSSSSSSSSSSSSSSSSSSSSSSSSSSSSSSS------------
S------------SSSSSSSSSSSSSSS--------------------------------SSSSSSSSSSSSSSSSSSSSSSSSSSSSSSSSSSSSSSSSSSSSSS------SSSSSSSSSSSSSSS-----------------------
S-----------------------------------------------------------------SSSSSSSSSSSSSSSSSSSSSSSSSSS------SSSSSSS-------------SSSSSSSS-----------------------
S-----------------------------------------------------------------------------------------------------------------------------------------------------
S-----------------------------------------------------------------------------------------------------------------------------------------------------
S-----------------------------------------------------------------------------------------------------------------------------------------------------
S-----------------------------------------------------------------------------------------------------------------------------------------------------
S----------------------------------------------------------------------------------------------------------oSSS---------------------------------------
S---------------------------------------------------------------oSo-----------------------------------------------------------------------------------
S-------------------------------------------------------------------------------------------ooo------------oooooo-------------SooS-------------ooo----
S------------------oSoo-------------------------------ooSooo----oo---------------------------------------------------------------------ooo------------
S----------XXXXXX----------------------Tt------------------------------------------------XXXXXXX---------XXXXXXXXXXXXXXX------oo---------------oooooo-
S----------XXXXXX--ooooo--XXXXXX--tt---Tt-tt----------oooooo---XXXXXXX-ooo-----------XXXXXXXXXXX-ooooo---XXXXXXXXXXXXXXX------------XXXXXXXXX---------
SXXXXXXXXXXXXXXXX-----g---XXXXXX--tt---Tt-tt-XXX------g--------XXXXXXX--------XXXXX--XXXXXXXXXXX---------XXXXXXXXXXXXXXX--XXXXXXXXXXXXXXXXXXXXXXXXXXXX
SXXXXXXXXXXXXXXXXXXXXXXXXXXXXXXXXXXXXXXXXXXXXXXXXXXXXXXXXXXXXXXXXXXXXXXXXXXXXXXXXXXXXXXXXXXXXXXXXXXXXXXXXXXXXXXXXXXXXXXXXXXXXXXXXXXXXXXXXXXXXXXXXXXXXX

