S----SSSSSSSSSSSSSSSSSSSSSSSSSSSSSSSSSSSSSSSSSSSSSSSSSSSSSSSSSSSSSSSSSSSSSSSSSSSSSSSSSSSSSSSSSSSSSSSSSSSSSSSSSSSSSSSSSSSSSSSSSSSSSSSSSSSSSSSSSSSSSSSSS
S----SSSSSSSSSSSSSSSSS-----------------------------SSSSSSSSSSSSSSSSSSSSSSSSSSSS-----SSSSSSSSSSSSSSSSSSSSSSSSSSSSSSSSS--------SSSSSSSSSSSSSSSSSSSSSSSSS
S----SSSSSSSSSSSS------------------------------------------------------SSSSSSSS-------------SSSSSSSSSSSSSSSSSSSSSSSSS--------SSSSSSSSSSSSSSSSSSSSS----
S----SSSSSSSSSSSS---------------------------------------------------------------------------SSSSSSSSSSSS------SSSSSSS--------SSSSSSSSSSSSS------------
S-----------------------------------------------------------------------------------------------------------------------------------------------------
S-----------------------------------------------------------------------------------------------------------------------------------------------------
S-----------------------------------------------------------------------------------------------------------------------------------------------------
S-----------------------------------------------------------------------------------------------------------------------------------------------------
S---------------------------------------oSSo----------------------------------------------------------------------------------------------------------
S---------------------------------------------------------------------------------------------SSoooooo------------------------------------------------
S----------------------------------------ooo-------------ooo---------------------------------------------------SSoSS----------------------------------
S-----------------------SSoSS-----------g------ooSoSS--------------------------oooooo---------ooooo-------------------------------------ooooo---ooooo-
SXXXXXXXXX-----------------------------XXXXXX----------XXXXXX----------------------------------------------------ooooo-XXX----------------------------
SXXXXXXXXX--------------oooooo---------XXXXXX---ooooo--XXXXXX--------------XX----oooo-------XXXXXXXXXXX----------------XXX--------------ooooo-XXXXXXXX
SXXXXXXXXX---------XXX-----------XXX---XXXXXX----------XXXXXX--------------XX----g------XX--XXXXXXXXXXXXXXXXXXXXXXXXXXXXXX--------------------XXXXXXXX
SXXXXXXXXXXXXXXXXXXXXXXXXXXXXXXXXXXXXXXXXXXXXXXXXXXXXXXXXXXXXXXXXXXXXXXXXXXXXXXXXXXXXXXXXXXXXXXXXXXXXXXXXXXXXXXXXXXXXXXXXXXXXXXXXXXXXXXXXXXXXXXXXXXXXX

