S----SSSSSSSSSSSSSSSSSSSSSSSSSSSSSSSSSSSSSSSSSSSSSSSSSSSSSSSSSSSSSSSSSSSSSSSSSSSSSSSSSSSSSSSSSSSSSSSSSSSSSSSSSSSSSSSSSSSSSSSSSSSSSSSSSSSSSSSSSSSSSSSSS
S----------SSSSSSSSSSSSSSSSSSSSSSSSSSSSSSSSSSSSSSSSSSSSSSSSSSSSSSSSSSSSSSSSSSSSSSSSSSSSSSSSSSSSS--------------SSSSSSSSSSSSS-------SSSSSSSSSSSSSSSSSSSS
S----------SSSSSS-----SSSSSSSSSSSSSSSSSS------SSSSSS--------------SSSSSSS-------------------------------------SSSSS-------------------------------SSSS
S---------------------SSSSSSSSSSSS--------------------------------SSSSSSS-------------------------------------SSSSS-----------------------------------
S-----------------------------------------------------------------------------------------------------------------------------------------------------
S-----------------------------------------------------------------------------------------------------------------------------------------------------
S-----------------------------------------------------------------------------------------------------------------------------------------------------
S-----------------------------------------------------------------------------------------------------------------------------------------------------
S-----------------oooooo------------------------------------------------------------------------------------------------------------------------------
S-----------------------------------------------------------------------------------------------------------------------------------------------------
S-----------------oooo--------------------oo-----------------------ooSSooo-----------------------------------------------------ooooo------------------
S--------------------------oSSoooSo----------------------------------------------------------------------------g--------------------------SoS---------
S----------------XXXXXXXX---------------XXXXXX---------------oooo---oooo-----------------------------------XXXXXX----------XXXXXXXXXXX----------------
SXXXXXXXXXXXXXXXXXXXXXXXX-oooooo--------XXXXXX--oooo------------------------------XXXXXXXX-----------oooo--XXXXXX-ooo------XXXXXXXXXXX----ooo---------
SXXXXXXXXXXXXXXXXXXXXXXXX-----------XXXXXXXXXX------------XXXXXXXXXXXXXXXXX-------XXXXXXXX-------XXX-------XXXXXX----------XXXXXXXXXXX----------------
SXXXXXXXXXXXXXXXXXXXXXXXXXXXXXXXXXXXXXXXXXXXXXXXXXXXXXXXXXXXXXXXXXXXXXXXXXXXXXXXXXXXXXXXXXXXXXXXXXXXXXXXXXXXXXXXXXXXXXXXXXXXXXXXXXXXXXXXXXXXXXXXXXXXXX

