S----SSSSSSSSSSSSSSSSSSSSSSSSSSSSSSSSSSSSSSSSSSSSSSSSSSSSSSSSSSSSSSSSSSSSSSSSSSSSSSSSSSSSSSSSSSSSSSSSSSSSSSSSSSSSSSSSSSSSSSSSSSSSSSSSSSSSSSSSSSSSSSSSS
S----SSSSSSSSSSSSSSSSSSSSS----------------SSSSSS-------------------SSSSSSSSSSSSSSSSSSSSSSSSSSSSSSSSSSSSSSSSSSSSSSSSSSSS--------------SSSSSSSSSSSSSSSSS
S----------SSSSSSSS------------------------------------------------SSSSSS--------------SSSSSSSSSSSSSSSSSSSSSSSSSSSSSSSS----------------------------SSS
S----------SSSSSSSS------------------------------------------------SSSSSS--------------SSSSSSSSSSSSSSS------SSSSSSSSSSS-------------------------------
S-----------------------------------------------------------------------------------------------------------------------------------------------------
S-----------------------------------------------------------------------------------------------------------------------------------------------------
S-----------------------------------------------------------------------------------------------------------------------------------------------------
S-----------------------------------------------------------------------------------------------------------------------------------------------------
S----------------------------------------------------------------oSoSo--------------------------------------------------------------------------------
S---------------------------------------------------------oSo-----------------------------------------------------------------------------------------
S-------------------------------------------------------------------ooo--------------oooSo------------------------------------------------------------
S---------------------------------------------------------------------g----ooSooSo------------------oooo---------oooSSo------ooo----------------------
S-----------XXXXX--------------XXX------------------XXXXX-------XXXXXXXXXX-------------------------------------------------------XXXXX-------XXXXXXXXX
S-----------XXXXXXXXXXXX-oooo--XXX------------------XXXXXXXXXXXXXXXXXXXXXX----ooo-------------------oooo-----------oooo----XXXXXXXXXXX---XXXXXXXXXXXXX
S-----------XXXXXXXXXXXX-------XXX-----------XXXXXXXXXXXXXXXXXXXXXXXXXXXXX---------XXXXXXXXXXXXX--g------XXXXXX------------XXXXXXXXXXXXXXXXXXXXXXXXXXX
SXXXXXXXXXXXXXXXXXXXXXXXXXXXXXXXXXXXXXXXXXXXXXXXXXXXXXXXXXXXXXXXXXXXXXXXXXXXXXXXXXXXXXXXXXXXXXXXXXXXXXXXXXXXXXXXXXXXXXXXXXXXXXXXXXXXXXXXXXXXXXXXXXXXXX

