S----SSSSSSSSSSSSSSSSSSSSSSSSSSSSSSSSSSSSSSSSSSSSSSSSSSSSSSSSSSSSSSSSSSSSSSSSSSSSSSSSSSSSSSSSSSSSSSSSSSSSSSSSSSSSSSSSSSSSSSSSSSSSSSSSSSSSSSSSSSSSSSSSS
S----SSSSSSSSSSSSSSSSSSSSSSSSSSSSSSSSSSSSSSSSSSSSSSSSSSSSSSSSSSSSSSSSSSSSSSSSSSSSSSSSSSSSSS-------SSSSSSSS----------------SSSSSS-------SSSSSSSSSSSSSSS
S-----------------SSSSSSSSSSSSSSSSSSSSSSSSS--------------------SSSSSSSSSSSSSSSSSSSSSSSSSSSS-------SSSSSSSS----------------SSSSSS-------SSSSSSSSSSSSSS-
S-------------------------------------SSSSS--------------------SSSSSSSSSSSSSS-------------------------------------------------------------------------
S-----------------------------------------------------------------------------------------------------------------------------------------------------
S-----------------------------------------------------------------------------------------------------------------------------------------------------
S-----------------------------------------------------------------------------------------------------------------------------------------------------
S-----------------------------------------------------------------------------------------------------------------------------------------------------
S----------------------ooSo---------------------------------------------------------------------------------------------------------------------------
S----------------------------------------------------------------ooo------oSSo-----------------ooSo---------------------------------------------------
S--------------ooSo----------------------------oSSS---------------------------------------------------------------------------------------------------
S-------------------------------------oooo-----------------------ooo------oooo-----------------ooooooo---------------------ooooooo---ooSooS-----------
S--------------oo----XXXXXXXX-----------------oooooo------------------------------XXXXXXXXXX---------------------------XXX----------------------------
SXXXXXXXXXXX---------XXXXXXXX--ooo--XXXXXXXX----g--------------XXXXXXXXXXXXXXXXXXXXXXXXXXXXXXXXXXXXXXXX------------XXXXXXXXXXXXXXXX----oooooo---------
SXXXXXXXXXXXXXXXXXXXXXXXXXXXX-------XXXXXXXXXXXXXXXXXXXXXXX----XXXXXXXXXXXXXXXXXXXXXXXXXXXXXXXXXXXXXXXXXXXXX---g---XXXXXXXXXXXXXXXX-----------XXX-----
SXXXXXXXXXXXXXXXXXXXXXXXXXXXXXXXXXXXXXXXXXXXXXXXXXXXXXXXXXXXXXXXXXXXXXXXXXXXXXXXXXXXXXXXXXXXXXXXXXXXXXXXXXXXXXXXXXXXXXXXXXXXXXXXXXXXXXXXXXXXXXXXXXXXXX

