S----SSSSSSSSSSSSSSSSSSSSSSSSSSSSSSSSSSSSSSSSSSSSSSSSSSSSSSSSSSSSSSSSSSSSSSSSSSSSSSSSSSSSSSSSSSSSSSSSSSSSSSSSSSSSSSSSSSSSSSSSSSSSSSSSSSSSSSSSSSSSSSSSS
S----------------SSSSS-----------SSSSS--------------SSSSSSSSSSSSSSSSSSSSSSSSSSS------SSSSSSSSSSSSSSSSSSSSSSSSSSSSSSSSSS-------SSSSSSSSSSSSS-------SSSS
S----------------SSSSS-----------SSSSS--------------------SSSSSSSSSSSSSS------------------SSSSSSSSSSSSSSSSSSSSSSSSSSSSS--------------SSSSSS-----------
S----------------SSSSS------------------------------------SSSSSS--------------------------SSSSSSSS----------SSSSSS------------------------------------
S-----------------------------------------------------------------------------------------------------------------------------------------------------
S-----------------------------------------------------------------------------------------------------------------------------------------------------
S-----------------------------------------------------------------------------------------------------------------------------------------------------
S-----------------------------------------------------------------------------------------------------------------------------------------------------
S-------------------------oooS-----------------------------------------oooooSo------------------------------------------------------------------------
S----------------------------------------------------------------------------------------------------oSoooo-------------------------------------------
S-----------------oo-------oo------------------------------------------oooo-----------Sooo--------------------------------ooSo------------------------
S---------------------------------------------------------------------------------------------------oooooo---------------------------SSSS-------------
SXXXXXXXXXXX---XXXXXXXXXXXXXXXXX-ooooo-XXXXXX-------------------------XXXXXXXXXXXXXX---oooooo------------------------XX---ooo-------------------------
SXXXXXXXXXXX---XXXXXXXXXXXXXXXXX---g---XXXXXXXXX---------oooo-XXXXX---XXXXXXXXXXXXXX---------------XXXXXXXXXX--oo--XXXX-------------oooo-----------XXX
SXXXXXXXXXXX---XXXXXXXXXXXXXXXXXXXXXXXXXXXXXXXXXXX------------XXXXXXXXXXXXXXXXXXXXXXXXXXXXXXXX-----XXXXXXXXXX------XXXXXXXXXXXXXX------g--g-XX-----XXX
SXXXXXXXXXXXXXXXXXXXXXXXXXXXXXXXXXXXXXXXXXXXXXXXXXXXXXXXXXXXXXXXXXXXXXXXXXXXXXXXXXXXXXXXXXXXXXXXXXXXXXXXXXXXXXXXXXXXXXXXXXXXXXXXXXXXXXXXXXXXXXXXXXXXXX

