S----SSSSSSSSSSSSSSSSSSSSSSSSSSSSSSSSSSSSSSSSSSSSSSSSSSSSSSSSSSSSSSSSSSSSSSSSSSSSSSSSSSSSSSSSSSSSSSSSSSSSSSSSSSSSSSSSSSSSSSSSSSSSSSSSSSSSSSSSSSSSSSSSS
S----SSSSSSSS------------SSSSSS-----------------------SSSSSSSSSSSSSSSSSSSSSSSSSS-----SSSSSSSSSSSSSSSS-----SSSSSSSSSSSSSSSSS--------SSSSSSSSSSSSSSSSSSS
S----SSSSSSSS----------------------------------------------SSSSSSSSSSSSSS------------SSSSSSSSSSSSSSSS-----------------SSSSS--------SSSSSSSSSSSSSSSSSSS
S----SSSSSSSS-----------------------------------------------------------------------------SSSSS-----------------------SSSSS--------SSSSS-------SSSSSSS
S-----------------------------------------------------------------------------------------------------------------------------------------------------
S-----------------------------------------------------------------------------------------------------------------------------------------------------
S-----------------------------------------------------------------------------------------------------------------------------------------------------
S-----------------------------------------------------------------------------------------------------------------------------------------------------
S------------------------------------------------------------Soooooo-------------ooo-----ooooo--------------------------------------------------------
S-----------------------------------------------------------------------------------------------------------------------------------------------------
S-------------------Sooo----------------ooo--------------------ooo------ooooo-----------oooooo----oSoSo-----------------------------------------------
S--------------------------------------------------SoSoo-----------------------------g---------------------------------ooS---------------oooSooo------
S-----------XXXXXX---oooo------------XXXXXXX---------------XXXXXXXXXXXXXXXXXXX--XXXXXXXXXXXXXXXXX----ooooo-------------------XX----tt------------XXXXX
S-----------XXXXXX-------------------XXXXXXX-------ooooo---XXXXXXXXXXXXXXXXXXX--XXXXXXXXXXXXXXXXX----------------------------XX----tt----oooo----XXXXX
SXXXXXXXXXXXXXXXXXXXXXXXXX-----------XXXXXXX--------g------XXXXXXXXXXXXXXXXXXXXXXXXXXXXXXXXXXXXXXXXXXXXXXXX-------XXXX-------XXXXXXXXXX----------XXXXX
SXXXXXXXXXXXXXXXXXXXXXXXXXXXXXXXXXXXXXXXXXXXXXXXXXXXXXXXXXXXXXXXXXXXXXXXXXXXXXXXXXXXXXXXXXXXXXXXXXXXXXXXXXXXXXXXXXXXXXXXXXXXXXXXXXXXXXXXXXXXXXXXXXXXXX

