S----SSSSSSSSSSSSSSSSSSSSSSSSSSSSSSSSSSSSSSSSSSSSSSSSSSSSSSSSSSSSSSSSSSSSSSSSSSSSSSSSSSSSSSSSSSSSSSSSSSSSSSSSSSSSSSSSSSSSSSSSSSSSSSSSSSSSSSSSSSSSSSSSS
S----SSSSSSSSSSSSSSSS------SSSSSSS------SSSSSSSSSSSSSSSSSSSSSSSSSSSSSSSSS--------------SSSSSSSSSSSSSSSSSSSSSSSSSSSSSSSSSSSSSSSSSSSSSSSSSSS--------SSSS
S----------SSSSSSSSSS------------------------SSSSSSSSSSSSSSSSSSSSSSSSSSSS--------------------SSSSSS--------------------------SSSSSSSSSSSSS------------
S---------------SSSSS------------------------SSSSSSSSSSSSSSSSSSSSSSSSSSSS--------------------SSSSSS---------------------------------------------------
S-----------------------------------------------------------------------------------------------------------------------------------------------------
S-----------------------------------------------------------------------------------------------------------------------------------------------------
S-----------------------------------------------------------------------------------------------------------------------------------------------------
S-----------------------------------------------------------------------------------------------------------------------------------------------------
S---------------------------------------------------------ooooSo------------------------------------------------------------------------ooo-----------
S------------------------------------oSoSoo----------------------------------------SSo-----------------oSoo-------------------------------------------
S--------------------------------------------------ooooo---------------------------------------------------------------------------------ooo----------
S-------------------ooSoS--------------oooooo---------------------oSS----------------------------------oooo------ooo----------------------------------
SXXXXXXXXXXX--------------------------------------XXXXXXXXXXXXXXX------------------g------------------------------------oooooo--------XXXXXXXXX-ooo---
SXXXXXXXXXXX--oo-----oooo------oo---XXXXXXXXXX--XXXXXXXXXXXXXXXXX---ooo----------XXXXXXX-------------XXXXXXXXXXXXXXXXXX--------XXXXX--XXXXXXXXX------X
SXXXXXXXXXXX------------------------XXXXXXXXXXXXXXXXXXXXXXXXXXXXX-------XXXXX----XXXXXXX-------------XXXXXXXXXXXXXXXXXXXXXXXXXXXXXXX--XXXXXXXXXXXXXXXX
SXXXXXXXXXXXXXXXXXXXXXXXXXXXXXXXXXXXXXXXXXXXXXXXXXXXXXXXXXXXXXXXXXXXXXXXXXXXXXXXXXXXXXXXXXXXXXXXXXXXXXXXXXXXXXXXXXXXXXXXXXXXXXXXXXXXXXXXXXXXXXXXXXXXXX

