S----SSSSSSSSSSSSSSSSSSSSSSSSSSSSSSSSSSSSSSSSSSSSSSSSSSSSSSSSSSSSSSSSSSSSSSSSSSSSSSSSSSSSSSSSSSSSSSSSSSSSSSSSSSSSSSSSSSSSSSSSSSSSSSSSSSSSSSSSSSSSSSSSS
S----SSSSSSSS------SSSSSSSSSSSSSSSSSSSSSSSSSSSSSSSSSSSSSSSSSSSSSSSSSSSSSSSSSSSSSSSSS-------SSSSSSSSSSSSS-----SSSSSSSS-------------SSSSS--------SSSSSSS
S------------------SSSSSSSSSSSSSSS------SSSSSSSSSSSSSSSSSSSS-----SSSSSSSSSSSSS-----------------------------------------------------------------SSSSSSS
S---------------------------------------SSSSSSSSSSSSSSSSSSSS-----SSSSSSSSSSSSS-----------------------------------------------------------------SSSSSSS
S-----------------------------------------------------------------------------------------------------------------------------------------------------
S-----------------------------------------------------------------------------------------------------------------------------------------------------
S-----------------------------------------------------------------------------------------------------------------------------------------------------
S-----------------------------------------------------------------------------------------------------------------------------------------------------
S-------------ooo----------------------------------------------------oooooS------------------------------------------------oSoo-----------------------
S-----------------------------------------------------------------------------------------------------------------------------------------------------
S--------------ooo------------------------------------ooSo------------oooooo----------------------oSo-------------------oooo--------------------------
S---------------g---------------------------------------------oo--------g----------------------------------------ooSo-------------oooo----------------
SXXXXXXXXXXXXXXXXXXXX------------XXX------------------ooooo----g----XXXXXXXXX---------------------ooooo----------------XXXXXXXXX----------------------
SXXXXXXXXXXXXXXXXXXXX-----XXXXXXXXXX-oooo--------------------XXXXXXXXXXXXXXXX-----XXXX-oo----------------------ooooooo-XXXXXXXXXXXXXXXXXXX----------XX
SXXXXXXXXXXXXXXXXXXXXXXXXXXXXXXXXXXX---------------XXXXXXXXXXXXXXXXXXXXXXXXXX-----XXXX--------XXXXXXXXXXX--------------XXXXXXXXXXXXXXXXXXXXXXXXXXXXXXX
SXXXXXXXXXXXXXXXXXXXXXXXXXXXXXXXXXXXXXXXXXXXXXXXXXXXXXXXXXXXXXXXXXXXXXXXXXXXXXXXXXXXXXXXXXXXXXXXXXXXXXXXXXXXXXXXXXXXXXXXXXXXXXXXXXXXXXXXXXXXXXXXXXXXXX

