S----SSSSSSSSSSSSSSSSSSSSSSSSSSSSSSSSSSSSSSSSSSSSSSSSSSSSSSSSSSSSSSSSSSSSSSSSSSSSSSSSSSSSSSSSSSSSSSSSSSSSSSSSSSSSSSSSSSSSSSSSSSSSSSSSSSSSSSSSSSSSSSSSS
S----SSSSSSSSSSSSSSS------SSSSSSSSSSSSSSSSSSSSSSSSSSSSSSSSSSSS--------------------SSSSSSSSSSSSSSSSSSSSSSSSSSSSSSSS-------SSSSSSSSSSSSSSSSSSSSSSSSSSSSS
S----SSSSSSSSSSSSSSS----------------------------SSSSSSS---------------------------------SSSSSSSSSSSSSSSSSSSSS-----------------SSSSSSSSSSSSSSSSS-------
S----SSSSSSSS-----------------------------------SSSSSSS---------------------------------SSSSSSSSSSSSSSSS----------------------------------------------
S-----------------------------------------------------------------------------------------------------------------------------------------------------
S-----------------------------------------------------------------------------------------------------------------------------------------------------
S-----------------------------------------------------------------------------------------------------------------------------------------------------
S-----------------------------------------------------------------------------------------------------------------------------------------------------
S--------------------------------------ooooo-----oSo--------------------------------------------------------------------------ooSSoo------------------
S--------------------------------------------------------------------oooSSSoo-------------------------------------------------------------------------
S------------------------------------oooooo-----oooo---------------------------ooooo------------------------------------------ooooo-------------------
S---------------ooo----SSoo------------g-------------------------------ooooo-----------------------oooS-------------oSoSooS-------g-------------------
SXXXXXXXXX------------------XXXXXXXXXXXXXXXXXXXXXXXXX-----------oo---------------oooo----------------------------------------XXXXXXXX-----------------
SXXXXXXXXX------------oooo--XXXXXXXXXXXXXXXXXXXXXXXXXXX------------XXXXXXXXXXX---------XX--------oooo---------XXXXX----ooo---XXXXXXXX----oo----oo-----
SXXXXXXXXXXXXXX-------------XXXXXXXXXXXXXXXXXXXXXXXXXXXXXXXXXXXXXXXXXXXXXXXXXXXXXXXXXXXXXXXXXXX---------------XXXXX----------XXXXXXXX----g----------XX
SXXXXXXXXXXXXXXXXXXXXXXXXXXXXXXXXXXXXXXXXXXXXXXXXXXXXXXXXXXXXXXXXXXXXXXXXXXXXXXXXXXXXXXXXXXXXXXXXXXXXXXXXXXXXXXXXXXXXXXXXXXXXXXXXXXXXXXXXXXXXXXXXXXXXX

