S----SSSSSSSSSSSSSSSSSSSSSSSSSSSSSSSSSSSSSSSSSSSSSSSSSSSSSSSSSSSSSSSSSSSSSSSSSSSSSSSSSSSSSSSSSSSSSSSSSSSSSSSSSSSSSSSSSSSSSSSSSSSSSSSSSSSSSSSSSSSSSSSSS
S----SSSSSSSSSSSSSS------SSSSSS------SSSSSSSSSSSS-------------SSSSSSSSSSSSSSSSSSSS------SSSSSSSSSSSSSSSSSSSSSSSSSSSSSSS-----SSSSSSSSSSSSSSSS--------SS
S------------------------------------SSSSSSSSSSSS-------------SSSSSSSSSSSSS-------------SSSSSSSSSSSSSSSSSSS------SSSSSS-----SSSSSSSSSSSSSSSS--------SS
S------------------------------------SSSSSSS----------------------------------------------------SSSSSSSSSSS-----------------SSSSSSSS------------------
S-----------------------------------------------------------------------------------------------------------------------------------------------------
S-----------------------------------------------------------------------------------------------------------------------------------------------------
S-----------------------------------------------------------------------------------------------------------------------------------------------------
S-----------------------------------------------------------------------------------------------------------------------------------------------------
S--------------------------------------------------------------------------------------SSoo------ooo---------------------oSoS-------------------------
S----------------SSo---------------oSSo----------oSSo-------------------------------------------------------ooo--------------------Soo----------------
S-----------------------------------------------------------------------ooooo----------ooo--------ooooo------------------oooo-------------------------
S-------------------------oSS-----ooo------------oooo------------------------------------------g-----g-----oooo---------------------------------------
S--------------------XX----------------------XXX------------------XXXXX------------XXXXXXXXXXXXXXXXXXXXX---g------------XXXXXXXXX---------------------
S-------------XXXXXXXXX-ooooooo--XXXXXXXX----XXXXXXXXX------------XXXXX---g---XXXXXXXXXXXXXXXXXXXXXXXXXXXXXXXXXXXX------XXXXXXXXXXXXXXXXXXXXXXX-------
SXXXXXXXXXXXXXXXXXXXXXX----------XXXXXXXXXXXXXXXXXXXXX------------XXXXXXXXXXXXXXXXXXXXXXXXXXXXXXXXXXXXXXXXXXXXXXXX----XXXXXXXXXXXXXXXXXXXXXXXXX-------
SXXXXXXXXXXXXXXXXXXXXXXXXXXXXXXXXXXXXXXXXXXXXXXXXXXXXXXXXXXXXXXXXXXXXXXXXXXXXXXXXXXXXXXXXXXXXXXXXXXXXXXXXXXXXXXXXXXXXXXXXXXXXXXXXXXXXXXXXXXXXXXXXXXXXX

