S----SSSSSSSSSSSSSSSSSSSSSSSSSSSSSSSSSSSSSSSSSSSSSSSSSSSSSSSSSSSSSSSSSSSSSSSSSSSSSSSSSSSSSSSSSSSSSSSSSSSSSSSSSSSSSSSSSSSSSSSSSSSSSSSSSSSSSSSSSSSSSSSSS
S----SSSSSSSSSSSSSSSSSSSSSSSSSSSSSSSSSSSSSSSSSSSSSSSS-----SSSSSSSSSSSS------SSSSSSSSSSSSSSSSSSS-------SSSSSSSSSSSSSSSSSSSSSS-------SSSSSSSSSSSSSSSSSSS
S------------SSSSSSSSSSSSSSS------SSSSSSSSSSSSS-----------SSSSSS------------SSSSSSSSSSSSSSSSSSS-------SSSSSSSSSSSSSSSSSSSSSS-------SSSSSSSSSSSSSS-----
S------------SSSSSSS--------------------------------------SSSSSS------------------SSSSSSSSSSSSS-------SSSSSSS--------SSSSSSS-------SSSSSSSS-----------
S-----------------------------------------------------------------------------------------------------------------------------------------------------
S-----------------------------------------------------------------------------------------------------------------------------------------------------
S-----------------------------------------------------------------------------------------------------------------------------------------------------
S-----------------------------------------------------------------------------------------------------------------------------------------------------
S-----------------------------------------------------------------------------------------------------------------------------------------------------
S--------------------------------------oSoo-----ooo---------------------------------------------------------------------------------------------------
S----------------------------------------------------oooooooo--ooSSo----------------------------------------------------------------------oooo--------
S-------------------------------------ooooo--------------------------------ooooSSoo----oooSo--oooSo------------------------oooooSo--------------------
S------------oooo-----XXXXX--------------------g----XXXXXXXXXX-oooo---------------------------------XX---ooo---ooo------------------XXX--oooooo-------
S-------------------XXXXXXX--ooooo--XXXXXXXXXXXXXXXXXXXXXXXXXX-------XXXXX-ooooo------oooooo--------XX-----------------------oooooo-XXX---------XX----
SXXXXXXXXXXXXXXXXXXXXXXXXXX----g----XXXXXXXXXXXXXXXXXXXXXXXXXXXXXXXXXXXXXX----------------------g---XXXXXXXXXXXXXXXXXXXXXX----g-----XXXXXXXXXXXXXXXXXX
SXXXXXXXXXXXXXXXXXXXXXXXXXXXXXXXXXXXXXXXXXXXXXXXXXXXXXXXXXXXXXXXXXXXXXXXXXXXXXXXXXXXXXXXXXXXXXXXXXXXXXXXXXXXXXXXXXXXXXXXXXXXXXXXXXXXXXXXXXXXXXXXXXXXXX

