S----SSSSSSSSSSSSSSSSSSSSSSSSSSSSSSSSSSSSSSSSSSSSSSSSSSSSSSSSSSSSSSSSSSSSSSSSSSSSSSSSSSSSSSSSSSSSSSSSSSSSSSSSSSSSSSSSSSSSSSSSSSSSSSSSSSSSSSSSSSSSSSSSS
S----SSSSSSS-----SSSSSSSSSSSSSSSSSSSSSSSSSSSSSSSSSSSSSS------SSSSSSSSSSSSSSSSSSSSSSSSSSSSSSS-----SSSSSSSSSSSSSSSSSSSSS-----SSSSSSSS----------SSSSSSSSS
S----SSSSSSS-----SSSSSSS---------------SSSSSSSSSSSSSSSS------SSSSSSSSSSSSSSSSS-------SSSSSSS--------------------SSSSSS-----SSSSSSSS----------SSSSSSSSS
S--------------------------------------SSSSSS---------------------------SSSSSS---------------------------------------------SSSSSSSS----------SSSSSS---
S-----------------------------------------------------------------------------------------------------------------------------------------------------
S-----------------------------------------------------------------------------------------------------------------------------------------------------
S-----------------------------------------------------------------------------------------------------------------------------------------------------
S-----------------------------------------------------------------------------------------------------------------------------------------------------
S-------------------------------------------------------------------------------oSo-------------------------------------------------------------------
S---------------------------------------------------------------SSoooo-----------------------------------ooS----------------------------oSoSooo-------
S-------------------------------------------------------------------------------ooo----------------ooo------------------------------------------------
S-------------------tt-----------------oSo------------oSoo-------ooooo----------g---------------------------------------oSSSo-------------oooo--------
S-------------------tt--XXX-----XXXXXX---------ooo----------------------ooo---XXXXXXXXXXX-------ooooo----------------------------XXXXXX---------------
SXXXXXXXXXXXXXXXXXXXXXXXXXXXXXXXXXXXXX--oooo-----------oo--XXXXXXXXXXXX-------XXXXXXXXXXX-oooo----------XXXXXXXXXXXXXX---ooooooo-XXXXXXXXXXXXXXXX-----
SXXXXXXXXXXXXXXXXXXXXXXXXXXXXXXXXXXXXX-------XXXXXXX-------XXXXXXXXXXXXXXXXXXXXXXXXXXXXXX------XXXXXXXXXXXXXXXXXXXXXXX-----------XXXXXXXXXXXXXXXX-----
SXXXXXXXXXXXXXXXXXXXXXXXXXXXXXXXXXXXXXXXXXXXXXXXXXXXXXXXXXXXXXXXXXXXXXXXXXXXXXXXXXXXXXXXXXXXXXXXXXXXXXXXXXXXXXXXXXXXXXXXXXXXXXXXXXXXXXXXXXXXXXXXXXXXXX

