S----SSSSSSSSSSSSSSSSSSSSSSSSSSSSSSSSSSSSSSSSSSSSSSSSSSSSSSSSSSSSSSSSSSSSSSSSSSSSSSSSSSSSSSSSSSSSSSSSSSSSSSSSSSSSSSSSSSSSSSSSSSSSSSSSSSSSSSSSSSSSSSSSS
S----SSSSSSSSSSSSSSSSSSSS-------SSSSSSSS-----SSSSSSSSSSSSS------SSSSSSSSSSSSSSSSSSSSSSSSSSSS-------SSSSSSS-----SSSSSSSSSSSSSSSSSSSSSS------------SSSSS
S----SSSSSSSSSSSSSSSSSSSS-------SSSSSSSS-----SSSSSSSSSSSSS------SSSSSSSSSSSSSSSSSSSSSSSSSSSS-------SSSSSSS-----SSSSSSSSSSSSSS--------------------SSSSS
S----SSSSSSSSSSSSSSSSSSSS-------SSSSSSSS------------------------SSSSS------------SSSSSS------------SSSSSSS-----------SSSSSSSS--------------------SSSSS
S-----------------------------------------------------------------------------------------------------------------------------------------------------
S-----------------------------------------------------------------------------------------------------------------------------------------------------
S-----------------------------------------------------------------------------------------------------------------------------------------------------
S-----------------------------------------------------------------------------------------------------------------------------------------------------
S-----------------------------------------------------------------------------------------------------------------------------------------------------
S----------ooSoo------------------------------------------------------------ooo-----------------------------------------oSoo--------------------------
S------------------------------------------------------------ooSoSo---------------------------------------------------------------SoSSS-----------Soo-
S------------oooooo-----------oSo---------g---------SooSooo-----------------ooo---ooSSooo-----------------------------ooooooooo-----------------------
S-------------------------------------XXXXXXXXXXXX------------ooo----XXXXX-----------------------XXXXX----------------------------ooooo------------oo-
S---------XXXXXXXXXXXXXXXXXXX---------XXXXXXXXXXXX-ooooooo--------g--XXXXXXXXXXXX--oooooo--------XXXXX-----------XXXXXXXXXXXXXXX----g-----------------
S---------XXXXXXXXXXXXXXXXXXX---g---XXXXXXXXXXXXXX----------XXXXXXXXXXXXXXXXXXXXX----------------XXXXXXXXXXXXX---XXXXXXXXXXXXXXXXXXXXXXXXXXXXXXXXXXXXX
SXXXXXXXXXXXXXXXXXXXXXXXXXXXXXXXXXXXXXXXXXXXXXXXXXXXXXXXXXXXXXXXXXXXXXXXXXXXXXXXXXXXXXXXXXXXXXXXXXXXXXXXXXXXXXXXXXXXXXXXXXXXXXXXXXXXXXXXXXXXXXXXXXXXXX

