S----SSSSSSSSSSSSSSSSSSSSSSSSSSSSSSSSSSSSSSSSSSSSSSSSSSSSSSSSSSSSSSSSSSSSSSSSSSSSSSSSSSSSSSSSSSSSSSSSSSSSSSSSSSSSSSSSSSSSSSSSSSSSSSSSSSSSSSSSSSSSSSSSS
S----SSSSSSSSSSSSSSSSSSSSSSSSSSSSSSSS----------SSSSSSS-------SSSSS--------SSSSSSSSSSSSSSSSSSSSSSSSSS------SSSSSSSSSSSSSSSSSSSSSSSSSSSSSSSSSS----------
S----------SSSSS--------SSSSSSSSSSSSS----------SSSSSSS--------------------SSSSSSSSSSSSS-------------------SSSSSSSSSSSSSSSSSSS--------SSSSSSS----------
S-----------------------SSSSSSSSSSSSS----------SSSSSSS-------------------------------------------------------------------------------SSSSSSS----------
S-----------------------------------------------------------------------------------------------------------------------------------------------------
S-----------------------------------------------------------------------------------------------------------------------------------------------------
S-----------------------------------------------------------------------------------------------------------------------------------------------------
S-----------------------------------------------------------------------------------------------------------------------------------------------------
S------------------------------------------------------------------------------------------------------oSoSoSS------------------------------oSSoS-----
S------------------------------------------------------------------oSooooSSo-------------------------------------------------------ooooS--------------
S-----------------------------tt-----------oSooooo----------SoSoo-----------------ooooSoo----------------oooooo--oooooo------oooo-------------ooooo---
S-----------------------------tt---tt-Tt-----------------------------oooo----------------------------------r--------------y-r--------oo---------------
S------------------tt--tt-----tt---tt-Tt---ooooo------------oo------------------ooooooo--------XXX---XXXXXXXXXXX--ooo----XXXXXXXXX---y--y--XXXXXXXXXX-
S-------------XXXX-tt--tt----XXXXXXXXXXXXX----------XXXXXX--------XXXXXXXXXXX------------------XXXXXXXXXXXXXXXXX---------XXXXXXXXXXXXXXXXXXXXXXXXXXXX-
S-----------XXXXXXXXXXXXXXXXXXXXXXXXXXXXXXXXXXXXXXXXXXXXXXXXXXXXXXXXXXXXXXXXX--XXXXXXXXXXX-----XXXXXXXXXXXXXXXXXXXXXXXXXXXXXXXXXXXXXXXXXXXXXXXXXXXXXXX
SXXXXXXXXXXXXXXXXXXXXXXXXXXXXXXXXXXXXXXXXXXXXXXXXXXXXXXXXXXXXXXXXXXXXXXXXXXXXXXXXXXXXXXXXXXXXXXXXXXXXXXXXXXXXXXXXXXXXXXXXXXXXXXXXXXXXXXXXXXXXXXXXXXXXX

