S----SSSSSSSSSSSSSSSSSSSSSSSSSSSSSSSSSSSSSSSSSSSSSSSSSSSSSSSSSSSSSSSSSSSSSSSSSSSSSSSSSSSSSSSSSSSSSSSSSSSSSSSSSSSSSSSSSSSSSSSSSSSSSSSSSSSSSSSSSSSSSSSSS
S----SSSSSSSSSSSS--------SSSSSSS-----SSSSSSSSSSSSSSSSSSSSSSSSSSSSSSSSSSSSSSSSSSSSSSSSSSS---------------SSSSSSSSSSSSSSSSSSSSSSSSSSSSSSSSSSSSSSSS-------
S----SSSSSSSSSSSS--------------------SSSSSSSSSSSSSSS------SSSSSSSSSSSSSSSSSSSSSSSSSSSSSS---------------SSSSSSSSSSSS--------SSSSS-------SSSSSSSS-------
S----SSSSS-------------------------------------------------------------------------SSSSS---------------------SSSSSS-----------------------------------
S-----------------------------------------------------------------------------------------------------------------------------------------------------
S-----------------------------------------------------------------------------------------------------------------------------------------------------
S-----------------------------------------------------------------------------------------------------------------------------------------------------
S-----------------------------------------------------------------------------------------------------------------------------------------------------
S----------------------------------------------oooo---------------------------------------------------------------------------------------------------
S--------------------------oSooS----------------------------------------------------------------------------------------------------------------------
S-------------------------------------ooooo------oooo-----oSo-----ooSoSoSo------------------ooooS--------------------------------------------ooS------
S----------------------------oooo--------------------------------------------oo-----SSSo--------------------------------------------------------------
S---------------------XX--------------ooooooo-XXXXXXXX----oooooo---ooooo-----------------------oooo---------------------XXXXX-oo------oooo------------
S---------------------XXXXXXXXXXXXX-----------XXXXXXXX---k-----------------XXXXXX-ooooo---------------oooooo----ooooo-XXXXXXX-------------------------
SXXXXXXXXXX--r--------XXXXXXXXXXXXXXXXXXXXXXXXXXXXXXXXXXXXXXXXXXXXXXXXXXXXXXXXXXX-r--------XXXXXXXXX------------------XXXXXXXXXXXXXXXXXXXXXXXXXXXXXXXX
SXXXXXXXXXXXXXXXXXXXXXXXXXXXXXXXXXXXXXXXXXXXXXXXXXXXXXXXXXXXXXXXXXXXXXXXXXXXXXXXXXXXXXXXXXXXXXXXXXXXXXXXXXXXXXXXXXXXXXXXXXXXXXXXXXXXXXXXXXXXXXXXXXXXXX

