S----SSSSSSSSSSSSSSSSSSSSSSSSSSSSSSSSSSSSSSSSSSSSSSSSSSSSSSSSSSSSSSSSSSSSSSSSSSSSSSSSSSSSSSSSSSSSSSSSSSSSSSSSSSSSSSSSSSSSSSSSSSSSSSSSSSSSSSSSSSSSSSSSS
S------------SSSSSSSSSSSSS------SSSSSSSSSSSSSSSSSSSSSSSSSSSSSSSSS------SSSSSSSSSSSSSSSSSSSS------------SSSSSSSS--------SSSSSSS-----SSSSSS-------SSSSSS
S------------SSSSSS---------------------------SSSSSSSSSSSSSSSSSSS------SSSSSSSSSSSSSSSSSSSS------------SSSSSSSS--------SSSSSSS-----SSSSSS-------------
S---------------------------------------------------SSSSSSSSSSSSS-----------SSSSSSSSSSSSSSS----------------------------SSSSSSS------------------------
S-----------------------------------------------------------------------------------------------------------------------------------------------------
S-----------------------------------------------------------------------------------------------------------------------------------------------------
S-----------------------------------------------------------------------------------------------------------------------------------------------------
S-----------------------------------------------------------------------------------------------------------------------------------------------------
S-------------------------ooS------------------------------------SooSSSS-------------------------oooooo-----------------------------------------------
S-----------------------------------------------------------------------------------------------------------------------------------------------------
S-------------------------ooo-----------------------------------oooooo---------------------------oooooo-----------------------------------------------
S-----------------------r-----------oSoo-------------------------------------------------------------------------oSo-----------oSoSSo-----------------
S---------------------XXXXXXXXXXXX------------------XXXXXX-----XXXXXXXXXXX--------------------XXXXXXXXXXXXXXX----------------------------oo-----------
S---------------------XXXXXXXXXXXX------------------XXXXXX-----XXXXXXXXXXX-----XXXXXXXXXXXXXXXXXXXXXXXXXXXXXX--ooooooo-------oooooo-------------ooooo-
S------------XXXXX----XXXXXXXXXXXX-------k---XXXXXXXXXXXXXXXXXXXXXXXXXXXXX-----XXXXXXXXXXXXXXXXXXXXXXXXXXXXXX--y-k--------------------XXXXXXX---------
SXXXXXXXXXXXXXXXXXXXXXXXXXXXXXXXXXXXXXXXXXXXXXXXXXXXXXXXXXXXXXXXXXXXXXXXXXXXXXXXXXXXXXXXXXXXXXXXXXXXXXXXXXXXXXXXXXXXXXXXXXXXXXXXXXXXXXXXXXXXXXXXXXXXXX

