S----SSSSSSSSSSSSSSSSSSSSSSSSSSSSSSSSSSSSSSSSSSSSSSSSSSSSSSSSSSSSSSSSSSSSSSSSSSSSSSSSSSSSSSSSSSSSSSSSSSSSSSSSSSSSSSSSSSSSSSSSSSSSSSSSSSSSSSSSSSSSSSSSS
S----SSSSSSSSSSSSS-------SSSSSSSSSSSS-------SSSSS----------------SSSSSSSSSSSSSSSSSSSSS--------SSSSSSS-----SSSSSSSSSSSSSSSSSSSSSS----------------------
S----SSSSSSSSSSSSS--------------------------SSSSS----------------SSSSSSSSSSSSSSSSSSSSS--------SSSSSSS-----SSSSSSSSSS-----SSSSSSS----------------------
S-----------SSSSSS--------------------------SSSSS----------------SSSSSSSSSSSSSSSSSSSSS--------SSSSSSS-----SSSSSSSSSS----------------------------------
S-----------------------------------------------------------------------------------------------------------------------------------------------------
S-----------------------------------------------------------------------------------------------------------------------------------------------------
S-----------------------------------------------------------------------------------------------------------------------------------------------------
S-----------------------------------------------------------------------------------------------------------------------------------------------------
S-------------------------------------------------SSSoooo------------------------------------------------------------------ooo-----------------ooSooo-
S-----------------------------------------------------------------------------------------------------------------------------------------------------
S-------------------------------------------------oooo-------oSoooo------------------------------ooS------------------------ooo--------------oooooo---
S--------------------------------------ooooo--------r--------------------------oSo-----ooo--------------------------------------------oSSS------------
SXXXXXXXXXXXX---------Tt-tt---------------------XXXXXXXXXX-oooooooo------------------------------ooooo--------------------XXXXXXXX----------XXXXXXXXXX
SXXXXXXXXXXXX---------Tt-tt------------oo----XXXXXXXXXXXXX------------------oooooooo---oo--------------XXXXXX-------------XXXXXXXX----oooo--XXXXXXXXXX
SXXXXXXXXXXXX---------Tt-tt----XXXX----------XXXXXXXXXXXXXXXXXXXXXXXXXXXXXX---K--------------XXXXXXXXXXXXXXXXXXXXXXXXXXXXXXXXXXXXX----------XXXXXXXXXX
SXXXXXXXXXXXXXXXXXXXXXXXXXXXXXXXXXXXXXXXXXXXXXXXXXXXXXXXXXXXXXXXXXXXXXXXXXXXXXXXXXXXXXXXXXXXXXXXXXXXXXXXXXXXXXXXXXXXXXXXXXXXXXXXXXXXXXXXXXXXXXXXXXXXXX

