S----SSSSSSSSSSSSSSSSSSSSSSSSSSSSSSSSSSSSSSSSSSSSSSSSSSSSSSSSSSSSSSSSSSSSSSSSSSSSSSSSSSSSSSSSSSSSSSSSSSSSSSSSSSSSSSSSSSSSSSSSSSSSSSSSSSSSSSSSSSSSSSSSS
S-----------SSSSSS-----SSSSSSSSSSSSSSSSSSS---------------SSSSSSSSSSSSSSSSSSS------SSSSSSSSSSSSSSSSSSSSSSS-------------SSSSSSSSSSSSSSSSSSSSSSSSSSS-----
S-----------SSSSSS-----SSSSSSSSSSSSSSSSSSS-----------------------SSSSS------------SSSSSSSSSSSSSSSS---------------------------------SSSSSS-------------
S----------------------SSSSSSS-----------------------------------------------------------------------------------------------------SSSSSS-------------
S-----------------------------------------------------------------------------------------------------------------------------------------------------
S-----------------------------------------------------------------------------------------------------------------------------------------------------
S-----------------------------------------------------------------------------------------------------------------------------------------------------
S-----------------------------------------------------------------------------------------------------------------------------------------------------
S----------------------oSooo--------------------------------------------------------------------------------------------------------------------------
S---------------------------------------ooSoo------------------------------oooo------------------------------------------------------------oSSSSSS----
S----------------------oooo---------------------------------------------------------------------------------------------------------------------------
S--------------------------------------ooooo----------ooo------------------ooo--------------ooo----------ooo------------ooooSo-------------oooooooo---
S-------------oooo-XXXXXXXXXX-----------r--------------------------XXXX-------------------k---------------y--r--------------------XXXX-----------y----
S----------------k-XXXXXXXXXX----XX---XXXXXXXXXXXXXXXXXXXXXX--oo---XXXXXXXXXXXXXXXXXXXXXXXXXXXXX--XXXXXXXXXXXXXXX-oooo---ooooooo--XXXXXXXXXXXXXXXXXXXX
SXXXXXXXXXXXXXXXXXXXXXXXXXXXXXXXXXX---XXXXXXXXXXXXXXXXXXXXXX-------XXXXXXXXXXXXXXXXXXXXXXXXXXXXX--XXXXXXXXXXXXXXX----k------------XXXXXXXXXXXXXXXXXXXX
SXXXXXXXXXXXXXXXXXXXXXXXXXXXXXXXXXXXXXXXXXXXXXXXXXXXXXXXXXXXXXXXXXXXXXXXXXXXXXXXXXXXXXXXXXXXXXXXXXXXXXXXXXXXXXXXXXXXXXXXXXXXXXXXXXXXXXXXXXXXXXXXXXXXXX

