S----SSSSSSSSSSSSSSSSSSSSSSSSSSSSSSSSSSSSSSSSSSSSSSSSSSSSSSSSSSSSSSSSSSSSSSSSSSSSSSSSSSSSSSSSSSSSSSSSSSSSSSSSSSSSSSSSSSSSSSSSSSSSSSSSSSSSSSSSSSSSSSSSS
S----SSSSS-------SSSSSSSSSSSSSSSSSSSSSSSSSSSSSSSSSSSS-------SSSSSSSSSSSSSSSSSSSSSS-----SSSSSSSSSSSSSSSSSSSSSSSSSSSSSSSSSS------SSSSSSSSSSSSSSSSSSSSSSS
S----------------SSSSSSSSSSSSSSSSSSSSSSSSS-----SSSSSS-------SSSSSSSSSSSSSSSSSSSSSS-----SSSSSSSSSSSSSSSSSSSSSSSSSSSSS-----------------------SSSSSSSSSSS
S---------------------SSSSSSS-------SSSSSS-----SSSSSS------------------SSSSSS----------SSSSSSSSSSSS-----SSSSSSSSSSSS-----------------------SSSSSSSSSSS
S-----------------------------------------------------------------------------------------------------------------------------------------------------
S-----------------------------------------------------------------------------------------------------------------------------------------------------
S-----------------------------------------------------------------------------------------------------------------------------------------------------
S-----------------------------------------------------------------------------------------------------------------------------------------------------
S-----------------------------------------------------------------------------------------------------------------------------------------------------
S----------ooo---------------------------------------------------------------Sooo--oSoSo--------------------------------------------------------------
S--------------------------------oo------------ooSoo---oSoSooo--------------------------------------ooSoo----------------oo----------------oSSoSSoo---
S---------------------ooooooo----------ooSoo-----------------------------------oo---------------------------------------------------------------------
S------------y-----------------XXXXXXX-----------------oooooooo----------------------------tt---Tt---ooo---------XXXXXXXXXXXXX-------oo------oooo-----
S---------XXXXXXXX----oooooooo-XXXXXXX----ooo-----------r------------------XXXXXXXXXXXXXX--tt---Tt--------XX-----XXXXXXXXXXXXX-----------------r------
SXXXXXXXXXXXXXXXXXXX------r----XXXXXXX--------XXXXXXXXXXXXXXXXXXXXX------XXXXXXXXXXXXXXXX--tt---Tt-XXXXXXXXXXXXXXXXXXXXXXXXXXX----XXXXXXXXXXXXXXXXXX--
SXXXXXXXXXXXXXXXXXXXXXXXXXXXXXXXXXXXXXXXXXXXXXXXXXXXXXXXXXXXXXXXXXXXXXXXXXXXXXXXXXXXXXXXXXXXXXXXXXXXXXXXXXXXXXXXXXXXXXXXXXXXXXXXXXXXXXXXXXXXXXXXXXXXXX

