S----SSSSSSSSSSSSSSSSSSSSSSSSSSSSSSSSSSSSSSSSSSSSSSSSSSSSSSSSSSSSSSSSSSSSSSSSSSSSSSSSSSSSSSSSSSSSSSSSSSSSSSSSSSSSSSSSSSSSSSSSSSSSSSSSSSSSSSSSSSSSSSSSS
S----SSSSSSSSSSSSSSSSSS------SSSSSSSSSSSSSSSSSSSSSSSSSSSSSSSSSSSSSSSSSSSS------SSSSS-----SSSSSSS-----------SSSSSSSSSSSSSSSSSSSSSSSSSSSSSSSSSSSSSSSSSSS
S---------SSSSSSSSSSSSS------SSSSSS---------------SSSSSSSSSSSSSSSSSSSSSSS------SSSSS-----SSSSSSS-----------SSSSSSSSSSSSSSSSSSSSSSSSSSSSSSSSSS-------SS
S---------SSSSSSSS---------------------------------------------SSSSS---------------------SSSSSSS-----------SSSSSSS-------------SSSSSSS--------------SS
S-----------------------------------------------------------------------------------------------------------------------------------------------------
S-----------------------------------------------------------------------------------------------------------------------------------------------------
S-----------------------------------------------------------------------------------------------------------------------------------------------------
S-----------------------------------------------------------------------------------------------------------------------------------------------------
S-----------------------------------------------------SoSS--------------------------------------------------------------------------------------------
S------------------------------------------oSoo-----------------------------------------------------------------------------------oSoS--------ooS-----
S----------------------------------------------------ooooooo-----ooS----------------------------ooo---------------------------------------------------
S-------------oooo------------------------oo-----------r------------------------------------------yr-------------oSoSoo---r-------oooooo-------oooo---
S---------------------------------------------------XXXXXXXXXX---oooo---XXXXXX----XX-----------XXXXXX-------------------XXXXXXX-------------k---------
S------------------XXXXXX---------XXXXXXXXXXXXXXXXXXXXXXXXXXXX--r-------XXXXXX----XX--------oo-XXXXXXXXXXXXX-----oooo---XXXXXXXXXXXXXXXXX--XXXXXXXXX--
S------------------XXXXXX---XXXXXXXXXXXXXXXXXXXXXXXXXXXXXXXXXXXXXXXXXXXXXXXXXXXXXXXXXXXX-------XXXXXXXXXXXXX------------XXXXXXXXXXXXXXXXX--XXXXXXXXXXX
SXXXXXXXXXXXXXXXXXXXXXXXXXXXXXXXXXXXXXXXXXXXXXXXXXXXXXXXXXXXXXXXXXXXXXXXXXXXXXXXXXXXXXXXXXXXXXXXXXXXXXXXXXXXXXXXXXXXXXXXXXXXXXXXXXXXXXXXXXXXXXXXXXXXXX

