S----SSSSSSSSSSSSSSSSSSSSSSSSSSSSSSSSSSSSSSSSSSSSSSSSSSSSSSSSSSSSSSSSSSSSSSSSSSSSSSSSSSSSSSSSSSSSSSSSSSSSSSSSSSSSSSSSSSSSSSSSSSSSSSSSSSSSSSSSSSSSSSSSS
S----SSSSSSS-----SSSSSSSSSSSSSSSSSSSSSSSSSSSSSSSSS-----SSSSS-------SSSSSS-------SSSSS--------SSSSSSSSSSSSSSSSSSSS------SSSSSSSSSSSSSSSSSSSSSSSSSSSSSSS
S----SSSSSSS-----SSSSSSSSSSSSSSSSSSSSSSSSSSSSSSSSS-----SSSSS--------------------SSSSS--------SSSSSSSSSSSSSS------------SSSSSSSSSSSSSSSSSSSSSSSSSSSSSSS
S----SSSSSSS-----SSSSSSSSSSSS--------------------------SSSSS--------------------SSSSS--------SSSSSSSSSSSSSS-----------------SSSSSSSSSSSSSSSSSSSSSSSSSS
S-----------------------------------------------------------------------------------------------------------------------------------------------------
S-----------------------------------------------------------------------------------------------------------------------------------------------------
S-----------------------------------------------------------------------------------------------------------------------------------------------------
S-----------------------------------------------------------------------------------------------------------------------------------------------------
S------------------------------------------oooSoSSo-------------------------------------------------------------------------------------------oSSoo---
S----------oSoooS------------------oooo-----------------------------------------ooooo-----------------------------------------------------------------
S--------------------------------------------oooooo-----------------------------------------------------------------------------------------ooooooo---
S------------oooo-------------------oo--------r-k----------------------------ooooo--------------------oSooSoo-----------------oooS--------------------
S-----------------------------------------XXXXXXXXXXX-------------XXXX-------y---------------------XX-------------------------------------XXXXXXXXXX--
SXXXXXXXXXXXXXXXXXXX--------------XXXXXXXXXXXXXXXXXXX-------------XXXX-oooo-XXXXXXXXXX-------------XX-oooooo-------ooo--XXXXX----ooo--XXXXXXXXXXXXXX--
SXXXXXXXXXXXXXXXXXXXXXXXX----k----XXXXXXXXXXXXXXXXXXX--XXXXXXX----XXXX------XXXXXXXXXXXXXXXXXXXXXXXXX-------------------XXXXX-r-------XXXXXXXXXXXXXXXX
SXXXXXXXXXXXXXXXXXXXXXXXXXXXXXXXXXXXXXXXXXXXXXXXXXXXXXXXXXXXXXXXXXXXXXXXXXXXXXXXXXXXXXXXXXXXXXXXXXXXXXXXXXXXXXXXXXXXXXXXXXXXXXXXXXXXXXXXXXXXXXXXXXXXXX

