S----SSSSSSSSSSSSSSSSSSSSSSSSSSSSSSSSSSSSSSSSSSSSSSSSSSSSSSSSSSSSSSSSSSSSSSSSSSSSSSSSSSSSSSSSSSSSSSSSSSSSSSSSSSSSSSSSSSSSSSSSSSSSSSSSSSSSSSSSSSSSSSSSS
S----SSSSSSS-----SSSSSSSSSSSSSSSSSSSSSSSS-------SSSSSSSSSSSSSSSSSSSSSSSSSSSSSSSSSSSSSSSSSSSSS------SSSSSSSSSSS-----SSSSSSSSSSSSSSSSSSSSSSSSSSSSSSSSSSS
S---------------------SSSSSSSS-----SSSSSS------------SSSSSSSSSSSS--------------SSSSSS--------------SSSSSS-----------------SSSSSSSS-------SSSSS------SS
S----------------------------------SSSSSS----------------------------------------------------------SSSSSS---------------------------------------------
S-----------------------------------------------------------------------------------------------------------------------------------------------------
S-----------------------------------------------------------------------------------------------------------------------------------------------------
S-----------------------------------------------------------------------------------------------------------------------------------------------------
S-----------------------------------------------------------------------------------------------------------------------------------------------------
S-----------------------------------------oSoo--------------------------------------------------------------------------------------------------------
S---------------SSo-------------------------------------------oSo------------------------------ooooSo-------------------------------------------------
S------------------------------------------------oo------------------------------oooooo----------------------oo----------------------ooo--------------
S--------------ooooooo-----------ooo------------------------ooo---------------------------------oooooo------------------------------------------------
SXXXXXXXXXXX----------------------------XXXXXXXXXXXXXXXXXXX--------XXXXX---------oooooooo--------------XXXXXXXXXXXX-----oooo--------XXXXXX------------
SXXXXXXXXXXXXXXXXXXXXXXXXXXX------oo----XXXXXXXXXXXXXXXXXXXXXXXXXXXXXXXX----------------------XXXXXXXXXXXXXXXXXXXXX-----------XXXXXXXXXXXX-------XXXXX
SXXXXXXXXXXXXXXXXXXXXXXXXXXXXXXX--------XXXXXXXXXXXXXXXXXXXXXXXXXXXXXXXX--------XXXXXXXXXXX---XXXXXXXXXXXXXXXXXXXXX----XXXXXXXXXXXXXXXXXXXXXXXXXXXXXXX
SXXXXXXXXXXXXXXXXXXXXXXXXXXXXXXXXXXXXXXXXXXXXXXXXXXXXXXXXXXXXXXXXXXXXXXXXXXXXXXXXXXXXXXXXXXXXXXXXXXXXXXXXXXXXXXXXXXXXXXXXXXXXXXXXXXXXXXXXXXXXXXXXXXXXX

