S----SSSSSSSSSSSSSSSSSSSSSSSSSSSSSSSSSSSSSSSSSSSSSSSSSSSSSSSSSSSSSSSSSSSSSSSSSSSSSSSSSSSSSSSSSSSSSSSSSSSSSSSSSSSSSSSSSSSSSSSSSSSSSSSSSSSSSSSSSSSSSSSSS
S----SSSSSSSSSSSSSSSSSS------------SSSSSSSSSSSSSSSSSSSSSSSS--------SSSSSSSSSSSSS-------SSSSSSSS-------SSSSSSSSSSSSSSSSSSSSSSSSSSSSSSSSSSSSSSSSSSSSSSSS
S----------------------------------SSSSSSSS-----SSSSSSSSSSS--------SSSSSSSSSSSSS-------SSSSSSSS-------SSSSSSSSSSSSSSS--------------SSSSSSSS-------SSSS
S----------------------------------SSSSSSSS-----SSSSSSSSSSS-------------SSSSSSSS---------------------------------------------------SSSSSSSS-------SSSS
S-----------------------------------------------------------------------------------------------------------------------------------------------------
S-----------------------------------------------------------------------------------------------------------------------------------------------------
S-----------------------------------------------------------------------------------------------------------------------------------------------------
S-----------------------------------------------------------------------------------------------------------------------------------------------------
S-----------------------------------------------------------------------------------------------------------------------------------------------------
S-----------------------oooooo--------------------Sooo---oSo----------------oSooo---------------------------------------------------------------------
S---------------oSS---------------------ooSSoSo--------------------------------------------------------------------------------------ooooSo--ooSooSSo-
S-----------------------ooooo--------------------ooo-----ooooo------oooo----ooooooo-------------------------------------------ooooo-------------------
SXXXXXXXXXXXX--------------y------------ooooo------------------XXX------------y-----XXXXXXXXXXXX------------------------XXXXX----------------oooooo---
SXXXXXXXXXXXX--------XXXXXXXXXX----oo-----------XXXXXXXXXXXXXXXXXX-oooooo--XXXXXXXXXXXXXXXXXXXXX-----XXXXX--------------XXXXX--oooo--y----------------
SXXXXXXXXXXXXXXXXXXXXXXXXXXXXXX--k----XXXXXXXXXXXXXXXXXXXXXXXXXXXX---------XXXXXXXXXXXXXXXXXXXXX-----XXXXXXXXXXXXXXX----XXXXX-------XXXXXXXXXXXXXXXXXX
SXXXXXXXXXXXXXXXXXXXXXXXXXXXXXXXXXXXXXXXXXXXXXXXXXXXXXXXXXXXXXXXXXXXXXXXXXXXXXXXXXXXXXXXXXXXXXXXXXXXXXXXXXXXXXXXXXXXXXXXXXXXXXXXXXXXXXXXXXXXXXXXXXXXXX

