S----SSSSSSSSSSSSSSSSSSSSSSSSSSSSSSSSSSSSSSSSSSSSSSSSSSSSSSSSSSSSSSSSSSSSSSSSSSSSSSSSSSSSSSSSSSSSSSSSSSSSSSSSSSSSSSSSSSSSSSSSSSSSSSSSSSSSSSSSSSSSSSSSS
S----SSSSSSSSSSSSSSSSSSSSSSSSSSSSSSSSSSSSSSSS--------SSSSSSSSSSSSSSSSSSSS--------SSSSSSSSSSSS--------SSSSSSSSSSSSSSSS-----SSSSSSSSSSSSSSSSSSSSSSSSSSSS
S----SSSSSSS--------SSSSSSS-----------SSSSSSS---------------SSSSSSSSSSSSS----------------------------SSSSSSSSSSSSSSSS------------------SSSSSSSSSSSSSSS
S----------------------------------------------------------------------------------------------------SSSSSSSSSSSSSSSS------------------------SSSSSSSSS
S-----------------------------------------------------------------------------------------------------------------------------------------------------
S-----------------------------------------------------------------------------------------------------------------------------------------------------
S-----------------------------------------------------------------------------------------------------------------------------------------------------
S-----------------------------------------------------------------------------------------------------------------------------------------------------
S-----------------------------------------------------oooS----oooSSoS---------------------------------------------------------------------oSooooSS----
S-------------------ooSSo-----ooo-----------oSoo------------------------------------------------------------------------------------------------------
S-----------------------------------------------------oooooo---ooooo----------------------------------------------------------------ooo---oooooo------
S-------------------oooooo---------------------oooo-----------------------SSo---------------ooSS------------------------------------------------------
SXXXXXXXXXX---oo------------------------XXX---------XXXXXXXXXXXXXXXXXXXX-----------------------------------------------------------ooooo-XXXXXXXXXXX--
SXXXXXXXXXX------r-XXXXXXXXXXXXXXXX-----XXXXXXXXXXXXXXXXXXXXXXXXXXXXXXXX--------------XX----oo------ooo--------XXXXXX-------XX-----------XXXXXXXXXXX--
SXXXXXXXXXXXXXXXXXXXXXXXXXXXXXXXXXXXXXXXXXXXXXXXXXXXXXXXXXXXXXXXXXXXXXXX--------------XX-------------r----XXXXXXXXXXXXXXXXXXXX--XXXXXXXXXXXXXXXXXXXX--
SXXXXXXXXXXXXXXXXXXXXXXXXXXXXXXXXXXXXXXXXXXXXXXXXXXXXXXXXXXXXXXXXXXXXXXXXXXXXXXXXXXXXXXXXXXXXXXXXXXXXXXXXXXXXXXXXXXXXXXXXXXXXXXXXXXXXXXXXXXXXXXXXXXXXX

