S----SSSSSSSSSSSSSSSSSSSSSSSSSSSSSSSSSSSSSSSSSSSSSSSSSSSSSSSSSSSSSSSSSSSSSSSSSSSSSSSSSSSSSSSSSSSSSSSSSSSSSSSSSSSSSSSSSSSSSSSSSSSSSSSSSSSSSSSSSSSSSSSSS
S------------SSSSSSSSSSSSSSSSSSSSSSSSSSSSSSSSSSSSSSSSSSSSSSSSSSSSSSSSSSSSSSSSSSS------------SSSSSSSSSSSSSSSSSSSSSSSSSSSSSSSSSSSSSSSSSS-----------SSSSS
S-------------------SSSSSSSSSSSSSSS------SSSSS--------SSSSSS------SSSSSSSSSSSSSS------------------SSSSSSSSSSSS-------------------SSSSS-----------SSSSS
S-------------------SSSSSSSSSSSSSSS-------------------SSSSSS------SSSSSSSSSSSSSS------------------SSSSSS----------------------------------------------
S-----------------------------------------------------------------------------------------------------------------------------------------------------
S-----------------------------------------------------------------------------------------------------------------------------------------------------
S-----------------------------------------------------------------------------------------------------------------------------------------------------
S-----------------------------------------------------------------------------------------------------------------------------------------------------
S------------------------------------------------------------------------------------------------------------------ooSoo--ooS------------oSoooo-------
S-----------------------------------------------------------------------------------------------------------------------------------------------------
S----------------------------------------------------------------------------------oo-----------------oSooS------oooooo------oo--------ooooooo--------
S------------------------------------oooooo---oSooo-----------ooooooo-----SoS----------k-----Sooooo--------------------------y-------------r----------
SXXXXXXXXXXXXXX---------------XXXX---------------------------------------------XXXXXXXXXX--------------ooooooo-XXXXXXXXXXXXXXXXXX-----XXXXXXXXXX------
SXXXXXXXXXXXXXXXXXXXXXXXXXXXXXXXXX---ooooo----oooo---XXXX--------ooooo---------XXXXXXXXXX----ooo---------------XXXXXXXXXXXXXXXXXX-----XXXXXXXXXX-ooo--
SXXXXXXXXXXXXXXXXXXXXXXXXXXXXXXXXX-------------------XXXXXXXX-----Y------------XXXXXXXXXX-----------XXXXXXXXXXXXXXXXXXXXXXXXXXXXXXXXXXXXXXXXXXXX-k----
SXXXXXXXXXXXXXXXXXXXXXXXXXXXXXXXXXXXXXXXXXXXXXXXXXXXXXXXXXXXXXXXXXXXXXXXXXXXXXXXXXXXXXXXXXXXXXXXXXXXXXXXXXXXXXXXXXXXXXXXXXXXXXXXXXXXXXXXXXXXXXXXXXXXXX

