S----SSSSSSSSSSSSSSSSSSSSSSSSSSSSSSSSSSSSSSSSSSSSSSSSSSSSSSSSSSSSSSSSSSSSSSSSSSSSSSSSSSSSSSSSSSSSSSSSSSSSSSSSSSSSSSSSSSSSSSSSSSSSSSSSSSSSSSSSSSSSSSSSS
S----SSSSSSSSSSSSSSSSSSSSSS--------SSSSSSSSSSSSSSSSSSSSSSSSSSSSSSSSSSSSSSSSSSSSSSSSSSSSSSSSSSSSSSSS-------SSSSSSSSSSSSSSSSSSSSSSSSSSSSSSSSSSSSSSSSSSSS
S----SSSSSSSSSSSSSSSSSSSSSS----------------------SSSSSSS------SSSSS-----------SSSSSSS-------SSSSSSS---------------SSSSSSSSSS-------SSSSS--------SSSSS-
S---------SSSSS---------------------------------------------------------------SSSSSSS-----------------------------SSSSSSSSSS-------SSSSS--------SSSSS-
S-----------------------------------------------------------------------------------------------------------------------------------------------------
S-----------------------------------------------------------------------------------------------------------------------------------------------------
S-----------------------------------------------------------------------------------------------------------------------------------------------------
S-----------------------------------------------------------------------------------------------------------------------------------------------------
S------------SoSSoo----oSSoo-------------------------------ooo-----SSoo-------------------------ooSoo-------------------------------------------------
S------------------------------SoSo-------------------------------------------------------------------------oSSoSooo--------------------ooSo----------
S------------oooo-------oooo-----------------------Tt-----oooo-----oooo----------------SooSoo----oo---------------------------------------------------
S--------------------------------------------------Tt--------K------------------------------------r-r----------ooo---------ooSoooSoo---oooooooo-------
S---------XXXXXXXXXXXXXXXXXXX--------------------XXXXXXXXXXXXXXXXXXXXXXXX--------------oooooo-XXXXXXXXX----------r------------------------------------
SXXXXXXXXXXXXXXXXXXXXXXXXXXXXXXXXXXXXXXX--XXXX---XXXXXXXXXXXXXXXXXXXXXXXX--------XXXX------k--XXXXXXXXXXXXXXXXXXXXXXX---------oooo---XXXXXXXXXXX--ooo-
SXXXXXXXXXXXXXXXXXXXXXXXXXXXXXXXXXXXXXXX--XXXX---XXXXXXXXXXXXXXXXXXXXXXXXXXXXXXXXXXXXXXXXXXXXXXXXXXXXXXXXXXXXXXXXXXXX----------------XXXXXXXXXXX------
SXXXXXXXXXXXXXXXXXXXXXXXXXXXXXXXXXXXXXXX--XXXXXXXXXXXXXXXXXXXXXXXXXXXXXXXXXXXXXXXXXXXXXXXXXXXXXXXXXXXXXXXXXXXXXXXXXXXXXXXXXXXXXXXXXXXXXXXXXXXXXXXXXXXX

