S----SSSSSSSSSSSSSSSSSSSSSSSSSSSSSSSSSSSSSSSSSSSSSSSSSSSSSSSSSSSSSSSSSSSSSSSSSSSSSSSSSSSSSSSSSSSSSSSSSSSSSSSSSSSSSSSSSSSSSSSSSSSSSSSSSSSSSSSSSSSSSSSSS
S----SSSSSSSSSSSSSSSSSSSSSSSSSSSSSSSSSSSSSSSSSSSSSSSSSSSSSS-------------SSSSSSSSSSSSSSSSSSSSSSSSSSSSSSSSSSS-------------------------SSSSSSSSSSSSSSSSSS
S----------SSSSSSSSSSSSSSSSSSSSS-----------------SSSSSSSSSS-------------SSSSS---------------SSSSSSSSSSSSSSS-------------------------SSSSSSSSSSSSSSSSSS
S----------SSSSSSSSSSSSSSSSSSSSS-----------------SSSSS--------------------------------------SSSSSSS---------------------------------SSSSSSSSSSSSSS----
S-----------------------------------------------------------------------------------------------------------------------------------------------------
S-----------------------------------------------------------------------------------------------------------------------------------------------------
S-----------------------------------------------------------------------------------------------------------------------------------------------------
S-----------------------------------------------------------------------------------------------------------------------------------------------------
S----------------------------------------------oSSoSoo---oSo------------------------------------------------------------------------------------------
S-----------------------------------------------------------------------------------------------------------------------------------------Tt----------
S----------------------------------------------oooooooo-------------------oo--------------------------------------------------------------Tt----------
S------------------Tt---tt-------------------------r-------------------------------------------------oo-----ooSoo-------ooSoo-------------Tt----------
S------------------Tt---tt-----------oooo-----XXXXXXXXXXXXXXXX--------XXXXXXXX---XXXX-------------------------------XXX----------------XXXXXXXX-------
S-----------------XXXXXXXXXXXX------------XXXXXXXXXXXXXXXXXXXX--------XXXXXXXX---XXXXXXX------------XXXXXXX---ooo---XXX----oo-------k--XXXXXXXX-------
S-----------------XXXXXXXXXXXXXXXXXXXXXXXXXXXXXXXXXXXXXXXXXXXX--------XXXXXXXXXXXXXXXXXX------------XXXXXXX---------XXX------y---XXXXXXXXXXXXXXXXXXXXX
SXXXXXXXXXXXXXXXXXXXXXXXXXXXXXXXXXXXXXXXXXXXXXXXXXXXXXXXXXXXXXXXXXXXXXXXXXXXXXXXXXXXXXXXXXXXXXXXXXXXXXXXXXXXXXXXXXXXXXXXXXXXXXXXXXXXXXXXXXXXXXXXXXXXXX

