S----SSSSSSSSSSSSSSSSSSSSSSSSSSSSSSSSSSSSSSSSSSSSSSSSSSSSSSSSSSSSSSSSSSSSSSSSSSSSSSSSSSSSSSSSSSSSSSSSSSSSSSSSSSSSSSSSSSSSSSSSSSSSSSSSSSSSSSSSSSSSSSSSS
S----SSSSSSSSSSSSSSSSSSSSSSSSSSS-------SSSSSSSSSSSSSSSSSSSSSSSSSSSSS------SSSSSSSSSSSSSSSSSSSSSSSSSSSSSSSSSSSSSSSSSSSSSSSSSSSSSSSSSSSSSSSSSSSSSSSSSSSS
S----SSSSSSSSSSSSSSSSSSSSSSSSSSS-------SSSSSSSSSSSS-----SSSSS-------------SSSSSSSSSSSSSSSSSS-----SSSSSSSSSSSSSS-----SSSSSSSSSSSS-------SSSSSS---------
S----SSSSSSSSSSSSSSSSSSS----------------------SSSSS-----SSSSS-------------SSSSSSSSSSSSSSSSSS------------------------SSSSSSSSSSSS----------------------
S-----------------------------------------------------------------------------------------------------------------------------------------------------
S-----------------------------------------------------------------------------------------------------------------------------------------------------
S-----------------------------------------------------------------------------------------------------------------------------------------------------
S-----------------------------------------------------------------------------------------------------------------------------------------------------
S---------------------ooS---------------------------------------------------------------ooooo---------------------------------------------------------
S-----------------------------------------------------------------------------------------------------------------------------------------------------
S----------------------oo----oSooooSo------------------------------------oo---------------oooooo---------oSSo-----------------------------------------
S--------------------------------------------------------------------------------oooo---r---------------------------ooS---------------oSoo---------oo-
S-------------ooo---XXXXXXXX---oooooo-------XXXXX-----------------XXX--XXXXXXX---------XXXXXXXXXX------ooooo-------------XXXXXXXX---------------------
S-------------------XXXXXXXX----------------XXXXX-------------oo--XXX--XXXXXXX-oooooo--XXXXXXXXXXXXXXX-------------oo----XXXXXXXX---------------XXXXXX
SXXXXXXXXXXXXXXXXXXXXXXXXXXXXXXXXXXXXX------XXXXXXXXXXXXX---------XXXXXXXXXXXX---------XXXXXXXXXXXXXXXXXXXXXXXXXXX-------XXXXXXXX------R---XXXXXXXXXXX
SXXXXXXXXXXXXXXXXXXXXXXXXXXXXXXXXXXXXXXXXXXXXXXXXXXXXXXXXXXXXXXXXXXXXXXXXXXXXXXXXXXXXXXXXXXXXXXXXXXXXXXXXXXXXXXXXXXXXXXXXXXXXXXXXXXXXXXXXXXXXXXXXXXXXX

