S----SSSSSSSSSSSSSSSSSSSSSSSSSSSSSSSSSSSSSSSSSSSSSSSSSSSSSSSSSSSSSSSSSSSSSSSSSSSSSSSSSSSSSSSSSSSSSSSSSSSSSSSSSSSSSSSSSSSSSSSSSSSSSSSSSSSSSSSSSSSSSSSSS
S----SSSSSSSSSSSSSSSSSSSSSSSSSSSSSSSSSSSSSSSSSSSSSSSSSSSSSSSSSSSSSSSSSSSSSSSSSSSSSSSSSSSSSSSSSSSS-------------------SSSSSSSSSSSSSSSSSSSSSSSSSSSSSSSSSS
S----SSSSSS---------------------SSSSS--------SSSSSSSSSSSSS-------SSSSSSSSSSSSSS------SSSSSS-------------------------------------SSSSSSSSSSSSSSSSSSSSSS
S-------------------------------------------------------------------------------------------------------------------------------------SSSSSSSSSSSSSSSS
S-----------------------------------------------------------------------------------------------------------------------------------------------------
S-----------------------------------------------------------------------------------------------------------------------------------------------------
S-----------------------------------------------------------------------------------------------------------------------------------------------------
S-----------------------------------------------------------------------------------------------------------------------------------------------------
S-------------------------------------------------------------------------------------------Sooo------------oSS---------------------------------------
S----------------------------------------------------------------------------SooSS-------------------------------------------ooSoS------SoSo----------
S--------------------------------------------ooo------------------------------------------oooo-------------ooo-------ooSo-----------------------------
S---------------------------------------------------------------oSo--------oooooo--------------------------------------------oooooo--ooooo------------
S-----------XXXXXXXXXXX---------------tt--------ooo----------------------------------XXXXXXXXXXXXXXX-----XXXXXXXX-------oo----y-----------------------
SXXXXXXXXXXXXXXXXXXXXXX----oooo-------tt-Tt--------------------oooo-------XXXXXXXXXXXXXXXXXXXXXXXXXXXXXXXXXXXXXXXXXX--------XXXXXXXXXXXXXXXXX-------XX
SXXXXXXXXXXXXXXXXXXXXXX---------XXX---tt-Tt-XXXXXXXX----------------------XXXXXXXXXXXXXXXXXXXXXXXXXXXXXXXXXXXXXXXXXXXXXXXXXXXXXXXXXXXXXXXXXXXXXXXXXXXX
SXXXXXXXXXXXXXXXXXXXXXXXXXXXXXXXXXXXXXXXXXXXXXXXXXXXXXXXXXXXXXXXXXXXXXXXXXXXXXXXXXXXXXXXXXXXXXXXXXXXXXXXXXXXXXXXXXXXXXXXXXXXXXXXXXXXXXXXXXXXXXXXXXXXXX

