S----SSSSSSSSSSSSSSSSSSSSSSSSSSSSSSSSSSSSSSSSSSSSSSSSSSSSSSSSSSSSSSSSSSSSSSSSSSSSSSSSSSSSSSSSSSSSSSSSSSSSSSSSSSSSSSSSSSSSSSSSSSSSSSSSSSSSSSSSSSSSSSSSS
S--------------------------SSSSSSSSSSSSSSSSSSSSSSSSSSSSSSSSSSSSSSSSSSSSSSSSSSSSSSSSSSSSSSSSSSSSSSSSSSSSSSSSSSSSSSSSSSSSSSSSSSSSSSSSSSSSSSSSSSSSSSSSSSS
S--------------------------------SSSSSSS-------SSSSSS-----------SSSSSSSSSSSSSSSSSSSSSSS-------SSSSSSSSSSSSS-----------------SSSSSSSSSSSSSSSSS------SSS
S-----------------------------------------------------------------------SSSSSSSSSSSSSSS-------------------------------------SSSSSSSSSSSSSSSSS---------
S-----------------------------------------------------------------------------------------------------------------------------------------------------
S-----------------------------------------------------------------------------------------------------------------------------------------------------
S-----------------------------------------------------------------------------------------------------------------------------------------------------
S-----------------------------------------------------------------------------------------------------------------------------------------------------
S----------------oSooo-----------------------------------------------------------------------------------------------oSoSoooo-------ooo---------------
S--------------------------------------oSo------------------------oooooS---------------------Sooo-----------------------------------------------------
S------------------ooooo---------------------------------------------------------------------------------------------oooooo----------oo---------------
S---------------------------Soo---------------ooSSoooo----oSoo----ooooo---------------ooo----ooo-------------oooSo------------------------------------
S---------------XXXXXXXXX------------------------------------------------k--oooo----k-------k-y------rr--XX---------XXXXXXXXXXX----XXXXXXXX-----------
S---------------XXXXXXXXX-ooooo-------XXXXXX--ooooo-------oo----XXXXXXXXXXX--------XXXXXXXXXXXXXXXXXXXXXXXX----oo---XXXXXXXXXXXXXXXXXXXXXXXXX---------
S---------------XXXXXXXXX-k-----------XXXXXX-------k------------XXXXXXXXXXXXXXXXXXXXXXXXXXXXXXXXXXXXXXXXXXX---------XXXXXXXXXXXXXXXXXXXXXXXXX------XXX
SXXXXXXXXXXXXXXXXXXXXXXXXXXXXXXXXXXXXXXXXXXXXXXXXXXXXXXXXXXXXXXXXXXXXXXXXXXXXXXXXXXXXXXXXXXXXXXXXXXXXXXXXXXXXXXXXXXXXXXXXXXXXXXXXXXXXXXXXXXXXXXXXXXXXX

