S----SSSSSSSSSSSSSSSSSSSSSSSSSSSSSSSSSSSSSSSSSSSSSSSSSSSSSSSSSSSSSSSSSSSSSSSSSSSSSSSSSSSSSSSSSSSSSSSSSSSSSSSSSSSSSSSSSSSSSSSSSSSSSSSSSSSSSSSSSSSSSSSSS
S----SSSSSSSSSSSSSSSSSSSSSSSSSSSSSSSSSSSSSSSSSSSSSSSSSSSSSSSSSSSSSS-------------------------------SSSSSSSSSSSS-----SSSSSSSSSSSSSSSSSSS-----SSSSSSSSSSS
S----SSSSSSS-----SSSSSSSSSSSSSSSSSSS-----SSSSS-------SSSSSSSS-------------------------------------SSSSSSSSSSSS------------------SSSSSS------------SSSS
S----SSSSSSS----------SSSSSSSSSSSSSS-----SSSSS-------SSSSSSSS-------------------------------------SSSSSSSSSSSS------------------SSSSSS------------SSSS
S-----------------------------------------------------------------------------------------------------------------------------------------------------
S-----------------------------------------------------------------------------------------------------------------------------------------------------
S-----------------------------------------------------------------------------------------------------------------------------------------------------
S-----------------------------------------------------------------------------------------------------------------------------------------------------
S-----------------oooSS----------------------------------------------------------oooo-------Soo------------------------------------ooS----------------
S-------------------------------------------------------------------------------------------------------------------------oSoo----------------SSS-----
S------------------ooo-----------------ooSoo-------------------------------------oooooo----ooooo------------------------------------------------------
S----------------------r--oSo-----------------------------------------ooSo--------------------------Soo------------SSoo----ooooo------------ooooooo---
SXXXXXXXXXXXXX--XXXXXXXXX------XXXXX--ooooooo----------XXXXXXXXXXXX-----------XXXXXXXXXXXXXXXXXXXX--------------------------------XXXXXX--------------
SXXXXXXXXXXXXX--XXXXXXXXX--oo--XXXXX----------XX----XXXXXXXXXXXXXXX--oooooooo-XXXXXXXXXXXXXXXXXXXX-ooo--------------oooo-XXXXXXXXXXXXXXX---XXXXXXXXX--
SXXXXXXXXXXXXX--XXXXXXXXX------XXXXXXXXXXXXXXXXXXXXXXXXXXXXXXXXXXXX-----------XXXXXXXXXXXXXXXXXXXX------XXX---XXX--------XXXXXXXXXXXXXXX---XXXXXXXXXXX
SXXXXXXXXXXXXXXXXXXXXXXXXXXXXXXXXXXXXXXXXXXXXXXXXXXXXXXXXXXXXXXXXXXXXXXXXXXXXXXXXXXXXXXXXXXXXXXXXXXXXXXXXXX---XXXXXXXXXXXXXXXXXXXXXXXXXXXXXXXXXXXXXXXX

