S----SSSSSSSSSSSSSSSSSSSSSSSSSSSSSSSSSSSSSSSSSSSSSSSSSSSSSSSSSSSSSSSSSSSSSSSSSSSSSSSSSSSSSSSSSSSSSSSSSSSSSSSSSSSSSSSSSSSSSSSSSSSSSSSSSSSSSSSSSSSSSSSSS
S------------------SSSSSSSSSSSSSSSSSSSSSSSSSSSSSSSSSSSSSSSSSSSSSSSSSSSSSSSSS-------SSSSSSSSSSSS------SSSSSSSSSSSSSSSSSSSSSSSSSS---------------SSSSSSSS
S------------------------------------SSSSSSSSSSSSS--------SSSSSSSSSSSSSSSSSS-------SSSSS-------------SSSSSSSSSSSSS----------------------------SSSSSSSS
S------------------------------------SSSSSSSSSSSSS--------SSSSSSSSSSSSSSSSSS-------SSSSS-------------SSSSSS-----------------------------------SSSSSSSS
S-----------------------------------------------------------------------------------------------------------------------------------------------------
S-----------------------------------------------------------------------------------------------------------------------------------------------------
S-----------------------------------------------------------------------------------------------------------------------------------------------------
S-----------------------------------------------------------------------------------------------------------------------------------------------------
S-----------------------------------------------------------------------------------------------------------------------------------------------------
S----------------------------ooS----------------------------oSoooo-----------------------oSSoSo------SSooo---------------------------oooSoSoo---------
S-------------------------------------------------------------------ooo-----------------------------------------oooSoo--------------------------------
S--------------ooo-----------oooooo----------------------ooooooo-------------------------ooooo------oooo-------------------oooSS------oooo------------
S------------------XXX------------------oo--------------------------------------------------r-----------r-y-------oooooo-------------r----k---XXX-----
S----------XX-ooo--XXX-----XXXXXXXXX----------y---------XXXXXXXXXXX--------------------XXXXXXXXXXXXXXXXXXXXX------------y---ooooo--XXXXXXXXXXXXXX-----
S----------XX------XXXXXX--XXXXXXXXXXXXXXXXXXXXXXXXXXXXXXXXXXXXXXXXXXXXXXXXXXXXXXXXXXXXXXXXXXXXXXXXXXXXXXXXXXXXXXXXXXXXXXX---------XXXXXXXXXXXXXX-----
SXXXXXXXXXXXXXXXXXXXXXXXXXXXXXXXXXXXXXXXXXXXXXXXXXXXXXXXXXXXXXXXXXXXXXXXXXXXXXXXXXXXXXXXXXXXXXXXXXXXXXXXXXXXXXXXXXXXXXXXXXXXXXXXXXXXXXXXXXXXXXXXXXXXXX

