S----SSSSSSSSSSSSSSSSSSSSSSSSSSSSSSSSSSSSSSSSSSSSSSSSSSSSSSSSSSSSSSSSSSSSSSSSSSSSSSSSSSSSSSSSSSSSSSSSSSSSSSSSSSSSSSSSSSSSSSSSSSSSSSSSSSSSSSSSSSSSSSSSS
S----SSSSSSSSSSSSSSSSSSSSSSSSSSSSSSSSSSSSSSSSSSSSSSSSSSSSSSS-----SSSSSSS------SSSSSS------SSSSSS--------SSSSS-----SSSSSSSSSSSSSSSSSSSSSSSSSSSSSSSSSSSS
S----SSSSSSS-----SSSSSS-------SSSSSS--------SSSSSSSS-------------SSSSSSS--------------------------------SSSSS-----SSSSSS-------SSSSSS--------SSSSS----
S----SSSSSSS--------------------------------SSSSSSSS-----------------------------------------------------------------------------------------SSSSS----
S-----------------------------------------------------------------------------------------------------------------------------------------------------
S-----------------------------------------------------------------------------------------------------------------------------------------------------
S-----------------------------------------------------------------------------------------------------------------------------------------------------
S-----------------------------------------------------------------------------------------------------------------------------------------------------
S-----------------------------------------------------------------------------------------------------------------------------------------------------
S---------------------------------------------oSooo-----------------------Soo-------------------------------------------------------------------------
S---------------------------------ooS-----------------------------------------------------------------------------------------------------------------
S----------------SSSoo-----------------------------------------------------ooo------------ooo---oooSSoo--------------------ooo-----ooSoooo------------
SXXXXXXXXXXXXX------------------oooooo-----XX-----k---r-------------XXX-------------XXXX-r---------------------ooo-------------------------------XXXXX
SXXXXXXXXXXXXX----oo-------------k-y-------XXXXXXXXXXXXXXXXXXX--oo--XXXXXXXXXXXXXXXXXXXXXXXXXX----oooo---XXX--y----XX----XXXXXXXXX---ooooo-------XXXXX
SXXXXXXXXXXXXX------------XXXXXXXXXXXXXXXXXXXXXXXXXXXXXXXXXXXX------XXXXXXXXXXXXXXXXXXXXXXXXXX---k-y-----XXXXXXXXXXXX----XXXXXXXXX---------r-----XXXXX
SXXXXXXXXXXXXXXXXXXXXXXXXXXXXXXXXXXXXXXXXXXXXXXXXXXXXXXXXXXXXXXXXXXXXXXXXXXXXXXXXXXXXXXXXXXXXXXXXXXXXXXXXXXXXXXXXXXXXXXXXXXXXXXXXXXXXXXXXXXXXXXXXXXXXX

