S----SSSSSSSSSSSSSSSSSSSSSSSSSSSSSSSSSSSSSSSSSSSSSSSSSSSSSSSSSSSSSSSSSSSSSSSSSSSSSSSSSSSSSSSSSSSSSSSSSSSSSSSSSSSSSSSSSSSSSSSSSSSSSSSSSSSSSSSSSSSSSSSSS
S----SSSSSSSS-------SSSSSSSSSSSSSSSSSSSSSS-------SSSSSSSSSSSSSSSSSSSS-------SSSSSSSSSSSSSSSSSSSSSSSSSSSSSSSSSSSSSSSSSSSSSSSSSSSSSSSSSSSSSSSSSSSSSSSSS-
S----SSSSSSSS-------SSSSSSSSSSSSSSSSSSSSSS----------------------------------SSSSSSS-------SSSSSSSSSSSSSSSSSSSSSSSSSSSSSSSSSSSSSSSSS-------SSSSSSSSSSS-
S-------------------SSSSSSSSSSSSSSSSS---------------------------------------SSSSSSS------------SSSSSSSSSSSSSSS----------------------------SSSSSSSSSSS-
S-----------------------------------------------------------------------------------------------------------------------------------------------------
S-----------------------------------------------------------------------------------------------------------------------------------------------------
S-----------------------------------------------------------------------------------------------------------------------------------------------------
S-----------------------------------------------------------------------------------------------------------------------------------------------------
S------------------------------------------------------------------------------------ooSoo------------------------------------------------------------
S-------------ooSSooooo-------------------oooo--------------------------------------------------------------------------------------------------------
S-----------------------------------*------------*------------*--*-------------------oooo----ooo------------------------oooSoSo-----------------------
S----------------oooo---------------*------------*-*--*-------*--*-----oooo---------------------------------------------------------------------------
SXXXXXXXXXXXX------k-yr-XXX--XXX----*----------XXXXXXXXXXXXXX-*--*-----g-----------XXXXXXXXXXXXXXXXXX--XXX---tt---------------------------------------
SXXXXXXXXXXXXXXXXXXXXXXXXXX--XXX----*----XXXXXXXXXXXXXXXXXXXXXXXXXXXXXXXXXXX---Tt--XXXXXXXXXXXXXXXXXX--XXX---tt---------g-y---k-----------------------
SXXXXXXXXXXXXXXXXXXXXXXXXXX--XXX---XXXXXXXXXXXXXXXXXXXXXXXXXXXXXXXXXXXXXXXXX---Tt--XXXXXXXXXXXXXXXXXX--XXXXXXXXXXXX--XXXXXXXXXXXXXXX---XXXXXXXX--XXXX-
SXXXXXXXXXXXXXXXXXXXXXXXXXX--XXXXXXXXXXXXXXXXXXXXXXXXXXXXXXXXXXXXXXXXXXXXXXXXXXXXXXXXXXXXXXXXXXXXXXXX--XXXXXXXXXXXX--XXXXXXXXXXXXXXX---XXXXXXXX--XXXXX

