S----SSSSSSSSSSSSSSSSSSSSSSSSSSSSSSSSSSSSSSSSSSSSSSSSSSSSSSSSSSSSSSSSSSSSSSSSSSSSSSSSSSSSSSSSSSSSSSSSSSSSSSSSSSSSSSSSSSSSSSSSSSSSSSSSSSSSSSSSSSSSSSSSS
S----SSSSSSSSSSSSSSSSSSSSSSSSSSSSSSS------SSSSSSSSSSSSSSSSSSSSSSSSSSSSSSSSSSSSSSSSSSSSSSSSSSSSSSSSSSSSSSSSSSSSSSS--------------SSSSSSSS---------------
S----SSSSSSSSSSSSSSSSSSSSSSSSSS-----------SSSSSS-----------SSSSSS-----------SSSSSSSSSSSSSSSSSSSSS--------SSSSSSSS-------------------------------------
S----SSSSSSSSSSSSS-----------------------------------------SSSSSS-------------------SSSSSSSSSSSSS-----------------------------------------------------
S-----------------------------------------------------------------------------------------------------------------------------------------------------
S-----------------------------------------------------------------------------------------------------------------------------------------------------
S-----------------------------------------------------------------------------------------------------------------------------------------------------
S-----------------------------------------------------------------------------------------------------------------------------------------------------
S----------------Soo--------------ooSooo--------------------------------------------------------------------------------------------------------------
S------------------------------------------------------------------------------------------------------------ooSoo------------------------------------
S--------------oooo----------------ooooo----------------------ooo-------------------------------------------------------------------------SoooSS------
S-----------------y-------oSSoo---y----------Soooooo-----------r---y------------------------------------------ooo------------g--------*---------------
SXXXXXXXXXXXXXXXXXXXXX----------XXXXXXXXXXX-----------------XXXXXXXXX--------------------k----K-XX-----------r-----------XXXXXX-------*---oooo--------
SXXXXXXXXXXXXXXXXXXXXX-oooooooo-XXXXXXXXXXX----ooooo--------XXXXXXXXX-oooo--------oo---XXXXXXXXXXX-oooo---XXXXXXXXXXX----XXXXXX--*----*---------------
SXXXXXXXXXXXXXXXXXXXXX---k------XXXXXXXXXXX----------XXXXXXXXXXXXXXXX-G-K----------g-r-XXXXXXXXXXX--r-----XXXXXXXXXXXXXXXXXXXXXXXXXXXXXXXXXXXXXXXX----
SXXXXXXXXXXXXXXXXXXXXXXXXXXXXXXXXXXXXXXXXXXXXXXXXXXXXXXXXXXXXXXXXXXXXXXXXXXXXXXXXXXXXXXXXXXXXXXXXXXXXXXXXXXXXXXXXXXXXXXXXXXXXXXXXXXXXXXXXXXXXXXXXXXXXX

