S----SSSSSSSSSSSSSSSSSSSSSSSSSSSSSSSSSSSSSSSSSSSSSSSSSSSSSSSSSSSSSSSSSSSSSSSSSSSSSSSSSSSSSSSSSSSSSSSSSSSSSSSSSSSSSSSSSSSSSSSSSSSSSSSSSSSSSSSSSSSSSSSSS
S----SSSSSSSSSSSSSSSSSSSSSSSSSS--------SSSSSS-------SSSSSSSSSSSSSSSSSSSSSSSSSSSSSSSSSSSSSSSSSSSSSSSSSSSSSSSSSS-----SSSSSSSSSSSSSSSSSSSSSSSSSSSSSS-----
S----SSSSSSSS-------SSSSSS-------------SSSSSS----------------------SSSSSSSSSSS-------SSSSS------SSSSSSS------------SSSSS-----SSSSSSSS-------SSSSS-----
S--------------------------------------SSSSSS----------------------------------------------------------------------SSSSS--------------------SSSSS-----
S-----------------------------------------------------------------------------------------------------------------------------------------------------
S-----------------------------------------------------------------------------------------------------------------------------------------------------
S-----------------------------------------------------------------------------------------------------------------------------------------------------
S-----------------------------------------------------------------------------------------------------------------------------------------------------
S--------------------------------------------------------------------------------------------------------------------------------------------ooS------
S-----------------------------------------------------------------------oSo---------------------------------------------------------------------------
S-----------oSoSS-----------------Soooo-------Sooo------------------------------------ooSS-------oSoSS----------------------ooSSo--------------oo-----
S-------------------------------------------------------------------*----------SSS-------------------------------------------------------oo----y------
S--------------oo---XXXXX--XXXXX---ooooooo-----oo-----------------*-*------------------oooooo---ooooo----XXXXX---------------ooo--------g---XXXXXX----
S------------k------XXXXX--XXXXX-k---g---k-----g-----XXXXX---XXXX-*-*-XXXXXX---oooo-----------------k--y-XXXXX------------------r----XXXXXXXXXXXXXXXXX
S----------XXXXXXXXXXXXXX--XXXXXXXXXXXXXXXXXXXXXXXXXXXXXXX---XXXXXXXXXXXXXXX--------XXXXXXXXXXXXXXXXXXXXXXXXXX-------------XXXXXXXX--XXXXXXXXXXXXXXXXX
SXXXXXXXXXXXXXXXXXXXXXXXX--XXXXXXXXXXXXXXXXXXXXXXXXXXXXXXXXXXXXXXXXXXXXXXXXXXXXXXXXXXXXXXXXXXXXXXXXXXXXXXXXXXXXXXXXXX--XXXXXXXXXXXXXXXXXXXXXXXXXXXXXXX

