S----SSSSSSSSSSSSSSSSSSSSSSSSSSSSSSSSSSSSSSSSSSSSSSSSSSSSSSSSSSSSSSSSSSSSSSSSSSSSSSSSSSSSSSSSSSSSSSSSSSSSSSSSSSSSSSSSSSSSSSSSSSSSSSSSSSSSSSSSSSSSSSSSS
S------------------------SSSSSSSSSSSSSSSSSSSSSSSSSSSSSSSSSSSSSSSSSSSSSSSSSSSSSSSSS-------SSSSSSSS-------SSSSSS------SSSSSSSSSSSSSSSSSSSSSSSSSSSSSSSSSS
S------------------------SSSSSSSSSSSSSSSSSSSSSSSSSSSSSSSSSSSSSSSSSSS---------------------SSSSSSSS-------SSSSSS------------SSSSSSSS-------SSSSSSSSSSSSS
S------------------------SSSSSSS-----SSSSSS-----SSSSSSSS------SSSSSS------------------------------------------------------SSSSSSSS---------------SSSSS
S-----------------------------------------------------------------------------------------------------------------------------------------------------
S-----------------------------------------------------------------------------------------------------------------------------------------------------
S-----------------------------------------------------------------------------------------------------------------------------------------------------
S-----------------------------------------------------------------------------------------------------------------------------------------------------
S---------------------------------------oSooooo---SSoSoo----------------------------ooo---------------------------------------------------------------
S------------------------------------------------------------------------------------------------------ooooSSo------------------oSSooSoo---ooSoo------
S-------------------------ooSo----------ooooo------ooo-----------------------------------------oooS---------------------------------------------------
S------------oSo--------------------------Y------y----y-------------------------------g-----------------oooooooo-------------------ooooo----oo--------
S------------------------ooooo---------XXXXXXXXXXXXXXXXXXXXXXX--------XXXXXX---XXXXXXXXX------oooo---------------XXXX-----------g-kg--------------XXXX
S----------------XXXXXX-g-----g--------XXXXXXXXXXXXXXXXXXXXXXX--ooo---XXXXXX---XXXXXXXXX----------g-y-XXXXXXXXXXXXXXXXXXXX-----XXXXXXXXXXXXXXXXXXXXXXX
SXXXXXXXXX--k--K-XXXXXXXXXXXXXXX--r----XXXXXXXXXXXXXXXXXXXXXXX--------XXXXXXXXXXXXXXXXXX---XXXXXXXXXXXXXXXXXXXXXXXXXXXXXXX-----XXXXXXXXXXXXXXXXXXXXXXX
SXXXXXXXXXXXXXXXXXXXXXXXXXXXXXXXXXXXXXXXXXXXXXXXXXXXXXXXXXXXXXXXXXXXXXXXXXXXXXXXXXXXXXXXXXXXXXXXXXXXXXXXXXXXXXXXXXXXXXXXXXXXXXXXXXXXXXXXXXXXXXXXXXXXXX

