S----SSSSSSSSSSSSSSSSSSSSSSSSSSSSSSSSSSSSSSSSSSSSSSSSSSSSSSSSSSSSSSSSSSSSSSSSSSSSSSSSSSSSSSSSSSSSSSSSSSSSSSSSSSSSSSSSSSSSSSSSSSSSSSSSSSSSSSSSSSSSSSSSS
S----SSSSSSS-------SSSSSS------------------------------SSSSSSSSSSSSSSSSSSSSSSSSSSSSSSSSSSSSSSSSSSSSSSSSSSSSSSSSSSSSSSSSSSSSSSSSSSSSSSSSSSSSSSSSSSSSSSS
S----SSSSSSS-------SSSSSS------------------------------SSSSSSSSSSSSSSS-----SSSSSSSSSSSS-------SSSSSSSSSSSSSSSSSSSSSSSSSS---------------SSSSSSSSSSSSSSS
S------------------SSSSSS------------------------------SSSSSSS-------------SSSSSSSSSSSS---------------SSSSSS---------------------------SSSSSS-----SSSS
S-----------------------------------------------------------------------------------------------------------------------------------------------------
S-----------------------------------------------------------------------------------------------------------------------------------------------------
S-----------------------------------------------------------------------------------------------------------------------------------------------------
S-----------------------------------------------------------------------------------------------------------------------------------------------------
S-------------------------------------------------------------------------oSS-------------------------------------------------------------------------
S--------------------------------------------------------ooooo-----------------------------------------------------------------------------------ooo--
S-------------------------------------------------------------------------oooo------------------------------------------------------------------------
S---------------SSooo-------oooooo--------------------------ooo--oooo-----------------------oSSoo--------------------------------ooo--------------oo--
SXXXXXXXXXXX-----------------------XXXXXX-----------------g-------------XXXXXXXXX-------------------------------------------------------*-*---------r-
SXXXXXXXXXXX------ooooo-----oooooo-XXXXXX----XXX-g------XXXXXXXXXXXXXX--XXXXXXXXX------XXXX--oooooo---ooo------------------XXXXXXXXXXXX-*-*-----XXXXXX
SXXXXXXXXXXX--------------g--------XXXXXXXXXXXXXXXXXXX--XXXXXXXXXXXXXX--XXXXXXXXX------XXXX-K---------------XXX------------XXXXXXXXXXXX-*-*-XXXXXXXXXX
SXXXXXXXXXXXXXXXXXXXXXXXXXXXXXXXXXXXXXXXXXXXXXXXXXXXXXXXXXXXXXXXXXXXXXXXXXXXXXXXXXXXXXXXXXXXXXXXXXXXXXXXXXXXXXXXXXXXXXXXXXXXXXXXXXXXXXXXXXXXXXXXXXXXXX

