S----SSSSSSSSSSSSSSSSSSSSSSSSSSSSSSSSSSSSSSSSSSSSSSSSSSSSSSSSSSSSSSSSSSSSSSSSSSSSSSSSSSSSSSSSSSSSSSSSSSSSSSSSSSSSSSSSSSSSSSSSSSSSSSSSSSSSSSSSSSSSSSSSS
S------------SSSSSSSSSSSSSSSSSSSSSSSSSSSSSSSSSSSSSSSS-------------SSSSSSSSSSSSSSSSSSSSSSSSSSSSSSSSSSSSSSSSSSSSSSSSSSSSSSSSSSSSS-------SSSSSSSSSSSSS---
S-----------------SSSSS--------SSSSSSSS----------------------------------------SSSSSSSSSSSSSSSSSSSSSSS-------------SSSSSSSSSSSS-----------------------
S------------------------------------------------------------------------------SSSSSSSSSSSSSSSSSSSSSSS-------------------SSSSSS-----------------------
S-----------------------------------------------------------------------------------------------------------------------------------------------------
S-----------------------------------------------------------------------------------------------------------------------------------------------------
S-----------------------------------------------------------------------------------------------------------------------------------------------------
S-----------------------------------------------------------------------------------------------------------------------------------------------------
S------------------------------oSoo---------------------------------------------------oSSo---oSoooo----------------------------------------------ooSo-
S-----------------------------------------------oSoSoSS----------------------------------------------------------------------ooo----oooSSoooo---------
S---------------------------------oo----ooSoo--------------oSSoo-----------------------oo----ooooooo----oSSSS------------------------------------oo---
S---------------------------------r---------------oooo-----------------------------------------------------------oooo----------oo------oooo--------G--
S--------------ooo-----XXXXX--XXXXXXX---ooooo---------------ooooo-------------------XXXXXXXXXXXXXXXXXX----------------------------------------XXXXXXXX
S----------------------XXXXX--XXXXXXX-g-----r--XXXXXXXXXXX----k----------oooo--XXXXXXXXXXXXXXXXXXXXXXX----------oooo-----k--XXXXXXXXXXXXXXXXXXXXXXXXXX
S-----------XXXXXXXX---XXXXXXXXXXXXXXXXXXXXXXXXXXXXXXXXXXXXXXXXXXXX----------y-XXXXXXXXXXXXXXXXXXXXXXXXXXXXXXXX-----g-XXXXXXXXXXXXXXXXXXXXXXXXXXXXXXXX
SXXXXXXXXXXXXXXXXXXXXXXXXXXXXXXXXXXXXXXXXXXXXXXXXXXXXXXXXXXXXXXXXXXXXXXXXXXXXXXXXXXXXXXXXXXXXXXXXXXXXXXXXXXXXXXXXXXXXXXXXXXXXXXXXXXXXXXXXXXXXXXXXXXXXX

