S----SSSSSSSSSSSSSSSSSSSSSSSSSSSSSSSSSSSSSSSSSSSSSSSSSSSSSSSSSSSSSSSSSSSSSSSSSSSSSSSSSSSSSSSSSSSSSSSSSSSSSSSSSSSSSSSSSSSSSSSSSSSSSSSSSSSSSSSSSSSSSSSSS
S----SSSSSSSSSSSSSSSS-------SSSSSSS-------------SSSSSSSSSSSSSSSSS-----SSSSSSSSSSSSSSSSSSSSSSSSSSSS--------SSSSSSSSSSSSSSSSSSSSSSSSS-------------SSSSSS
S----SSSSSSSSSSSSSSSS----------------------------------SSSSSSSSSS-----SSSSSSSSSSSSSSS---------------------SSSSSSSSSSSSSSSSSSSSSSSSS-------------------
S----SSSSSSSSSSSSSSSS----------------------------------SSSSS--------------------SSSSS-----------------------------------------------------------------
S-----------------------------------------------------------------------------------------------------------------------------------------------------
S-----------------------------------------------------------------------------------------------------------------------------------------------------
S-----------------------------------------------------------------------------------------------------------------------------------------------------
S-----------------------------------------------------------------------------------------------------------------------------------------------------
S-------------------------------------------------------------------------------------------------------------------oSSo------------------------------
S-----------------------------------------------------------------------------------------------------------------------------------------------------
S---------------------ooooo------------------------------------------------------oooS-------------------------------oooooo-----SooSSSo----------------
S------------ooooSoo------------------------Sooo-----------oSSoo----------------------------------------------------G---rY----------------------------
S--------------------XXXXXXX--oooo---------------------------------------------ooooo--------ooo---g---------------XXXXXXXXX---oooooo------------------
S------------ooooooo-XXXXXXX-----------oo-----ooooo------oooooo----------------g-----g-----------XXXXXX-r---------XXXXXXXXXXX---k--k----ooooo-XXXXXXXX
S-------------g------XXXXXXXXXXXXXX-k----------yg--------k---k-g--------XXXXXXXXXXXXXXXX---XXXXXXXXXXXXXXXXXXX----XXXXXXXXXXXXXXXXXXXXX-----r-XXXXXXXX
SXXXXXXXXXXXXXXXXXXXXXXXXXXXXXXXXXXXXXXXXXXXXXXXXXXXXXXXXXXXXXXXXXX---XXXXXXXXXXXXXXXXXXXXXXXXXXXXXXXXXXXXXXXXXXXXXXXXXXXXXXXXXXXXXXXXXXXXXXXXXXXXXXXX

