S----SSSSSSSSSSSSSSSSSSSSSSSSSSSSSSSSSSSSSSSSSSSSSSSSSSSSSSSSSSSSSSSSSSSSSSSSSSSSSSSSSSSSSSSSSSSSSSSSSSSSSSSSSSSSSSSSSSSSSSSSSSSSSSSSSSSSSSSSSSSSSSSSS
S----SSSSSSS-------SSSSSSSSSSSSSSSSSSSSSSSSSS--------SSSSSSSSSSSSSSSSSSS-----SSSSSSSSSSSSSSSSSSS-----SSSSSSSSSSSSSSSSSSSSSS---------------------------
S----SSSSSSS-------SSSSSSSSSSSSSSSSSSSSSSSSSS--------------SSSSSSSSSSSSS-----SSSSSSSSSSSSSSSSSSS----------SSSSSS------SSSSS---------------------------
S-------------------------------SSSSSSSSSSSSS-------------------SSSSSSSS-----SSSSSSSSSSSSSSSSSSS----------------------SSSSS---------------------------
S-----------------------------------------------------------------------------------------------------------------------------------------------------
S-----------------------------------------------------------------------------------------------------------------------------------------------------
S-----------------------------------------------------------------------------------------------------------------------------------------------------
S-----------------------------------------------------------------------------------------------------------------------------------------------------
S--------------------------------------------------ooooooo-------------------------ooSooSSSo-----------------Soo--------------------------------------
S-----------------------------------------------------------------------------------------------------------------------------------------------------
S-------------------------------------------oo-----ooooooo----------------------------oooooo-----------------oo---------SoSo-----------ooooSS---------
S---------------------ooo---------------------------------------------------------------------oSooo---------------------------------------------------
S--------------------g---------------------XXXXXXXXXXXXXXXXXX-------------XXX-----XXXXXXXXXXX-------XXXXXXXXXXXXXXX---oooooo-------------ooooooo-XXXXX
S------------------XXXXXXXXXX---ooo---XXXXXXXXXXXXXXXXXXXXXXXXXXXX---XXXXXXXXXXXXXXXXXXXXXXXX-------XXXXXXXXXXXXXXXXX--------y--XXXXXX--y-----g--XXXXX
S----------XXXXXXXXXXXXXXXXXX---------XXXXXXXXXXXXXXXXXXXXXXXXXXXX---XXXXXXXXXXXXXXXXXXXXXXXX---Y---XXXXXXXXXXXXXXXXXXXXXXXXXXXXXXXXXXXXXXXXXXXXXXXXXX
SXXXXXXXXXXXXXXXXXXXXXXXXXXXXXXXXXXXXXXXXXXXXXXXXXXXXXXXXXXXXXXXXX---XXXXXXXXXXXXXXXXXXXXXXXXXXXXXXXXXXXXXXXXXXXXXXXXXXXXXXXXXXXXXXXXXXXXXXXXXXXXXXXXX

