S----SSSSSSSSSSSSSSSSSSSSSSSSSSSSSSSSSSSSSSSSSSSSSSSSSSSSSSSSSSSSSSSSSSSSSSSSSSSSSSSSSSSSSSSSSSSSSSSSSSSSSSSSSSSSSSSSSSSSSSSSSSSSSSSSSSSSSSSSSSSSSSSSS
S----SSSSSSSSSSSSSSSSSSSSSSSSSSSSSSSSS--------------SSSSSSSSSSSSSSSSSS--------SSSSSSSSSSSSS--------SSSSSSSSSSSSSSSSSS--------SSSSSSSSSSSSSSSSSSSSSSSSS
S-----------------------SSSSSSSS-------------------------SSSSS----------------SSSSSSSSSSSSS--------SSSSSSSSSSSSSSSSSS-------------SSSSSSSSSSSSSS------
S--------------------------------------------------------SSSSS----------------SSSSSS----------------------------SSSSS-------------------SSSSSSSS------
S-----------------------------------------------------------------------------------------------------------------------------------------------------
S-----------------------------------------------------------------------------------------------------------------------------------------------------
S-----------------------------------------------------------------------------------------------------------------------------------------------------
S-----------------------------------------------------------------------------------------------------------------------------------------------------
S-----------------------------------------------------------------------------------------------------------------------------------------------------
S--------------oooSSo---SoooSo---------------------------------------------------------------------------------oooo-----------------------------------
S-------------------------------------------------------------------------------------------------------------------------------oSoSS-----------ooSSo-
S--------------oooo------ooooo-----SSo-------ooooooo-----------------oo------------oooooo-----ooooo---------------------------------------------------
S-----------k-------r-----y--y--------------------------r-kr---------------oo-------------------------XXXXX-----r-------XXXXX---oooo------------ooo---
S----------XXXXXXXXXXXXXXXXXXXX-ooo----XXXXX--oooooo---XXXXXXXXXXXXXXXXX----g--XXX--oooooo-----oooo---XXXXX---XXXXXX----XXXXXXX----------oooo---------
SXXXXXXXXXXXXXXXXXXXXXXXXXXXXXX--R--rY-XXXXX-----------XXXXXXXXXXXXXXXXXXXXXXXXXXX---k-------------r--XXXXX---XXXXXX----XXXXXXXXXXXXXXXX--r---XXXXXXXX
SXXXXXXXXXXXXXXXXXXXXXXXXXXXXXXXXXXXXXXXXXXXXXXXXXXXXXXXXXXXXXXXXXXXXXXXXXXXXXXXXXXXXXXXXXXXXXXXXXXXXXXXXXXXXXXXXXXXXXXXXXXXXXXXXXXXXXXXXXXXXXXXXXXXXX

