S----SSSSSSSSSSSSSSSSSSSSSSSSSSSSSSSSSSSSSSSSSSSSSSSSSSSSSSSSSSSSSSSSSSSSSSSSSSSSSSSSSSSSSSSSSSSSSSSSSSSSSSSSSSSSSSSSSSSSSSSSSSSSSSSSSSSSSSSSSSSSSSSSS
S-------------------SSSSSSSSSS------SSSSSSSSSSSSSSSSSSSSSS------SSSSSSSSSSSSSSSSSSSSSSSSSSSSSSSSSSSSSSSSSSSSSSSSSSSS-----SSSSSSSSSSSSSSSSSS-----------
S-------------------SSSSSSSSSS------SSSSSSSSSSS-----------------SSSSSSSSSSSSSSSSSSSSSSSSSSSSSSSSSSSSSSSSSSSSSSSSSSSS----------------------------------
S-------------------SSSSSSSSSS------SSSSS-----------------------------SSSSSSSS--------SSSSS-------SSSSSSS-----SSSSSS----------------------------------
S-----------------------------------------------------------------------------------------------------------------------------------------------------
S-----------------------------------------------------------------------------------------------------------------------------------------------------
S-----------------------------------------------------------------------------------------------------------------------------------------------------
S-----------------------------------------------------------------------------------------------------------------------------------------------------
S-----------------------------------------------------------------oSoooSo-----------------------------------------------------------------------------
S---------------------------------------------------------------------------------------------ooSSo---------------------------------------------------
S-----------------------------------------------oooSoSSo--ooSooo-----oooo----------------------------------------------------------*------------------
S-----------------------------------------------------------------------------ooSSo-------------------------------oooooo-----------*------------------
S-----------XXXXXXXXXXXXXXXXXX---------XX---------ooooo----------XXXXXXXXX---------------------y------ooo-------------------XX-----*-XXXXX-------XXXXX
S-----------XXXXXXXXXXXXXXXXXX--oooooo-XXXXXX-------------r--Y---XXXXXXXXX--ooooooo-XXXXXXXXXXXXXXXX------XXXX----oooooooo--XX---XXXXXXXXX-------XXXXX
S-----------XXXXXXXXXXXXXXXXXX-ry------XXXXXX--XXXXXXXXXXXXXXXXXXXXXXXXXXX-----k----XXXXXXXXXXXXXXXXXXXXXXXXXX--------------XX---XXXXXXXXX----k--XXXXX
SXXXXXXXXXXXXXXXXXXXXXXXXXXXXXXXXXXXXXXXXXXXXXXXXXXXXXXXXXXXXXXXXXXXXXXXXXXXXXXXXXXXXXXXXXXXXXXXXXXXXXXXXXXXXXXXXXXXXXXXXXXXXXXXXXXXXXXXXXXXXXXXXXXXXX

