S----SSSSSSSSSSSSSSSSSSSSSSSSSSSSSSSSSSSSSSSSSSSSSSSSSSSSSSSSSSSSSSSSSSSSSSSSSSSSSSSSSSSSSSSSSSSSSSSSSSSSSSSSSSSSSSSSSSSSSSSSSSSSSSSSSSSSSSSSSSSSSSSSS
S----SSSSSS------SSSSSSSSSSSSSSSSSSSSSSSSSSSSSSSSSSSSSSSSSSSSSSSS-----SSSSSSSSSSSSSSSSS-------SSSSSSSSSSSSSSS------SSSSS------SSSSSSSSSSSS--------SSSS
S----SSSSSS------SSSSSSSSSSSSSSSSS-----SSSSSSSS----------SSSSSSSS-----SSSSSSSSSSS---------------------SSSSSSS------SSSSS-----------SSSSSSS--------SSSS
S---------------------------------------------------------------------SSSSSSSSSSS---------------------SSSSSSS------SSSSS------------------------------
S-----------------------------------------------------------------------------------------------------------------------------------------------------
S-----------------------------------------------------------------------------------------------------------------------------------------------------
S-----------------------------------------------------------------------------------------------------------------------------------------------------
S-----------------------------------------------------------------------------------------------------------------------------------------------------
S-------------------------------------------------------------------------------------------------------Sooooo---SSSSo--------------------------------
S-----------------SoooSo---------------------------------------------------------oSooo----------------------------------------------------------------
S----------------------------------------oSSoooo-------------------oSoooo--------------------------------ooooo---oooooo-------------------------------
S----------------ooooo-----------------------------------SooS--------------------ooooo-----------------------G------G--------ooo----------------SooS--
SXXXXXXXXXXXXX---k------------------r----ooooo---------------------oooo---------r---------------r----XXXXXXXXXXXXXXXXXXXXX----y-----------------------
SXXXXXXXXXXXXXXXXXXXXXXXX-----XXXXXXXXX--k--g------------ooooo-----------------XXXXXXXX-ooo---XXXXXXXXXXXXXXXXXXXXXXXXXXXXXXXXXXX----oooo-------oooo--
SXXXXXXXXXXXXXXXXXXXXXXXX-----XXXXXXXXXXXXXXXXXXX------------g--XXXXXXXXXX-----XXXXXXXX-------XXXXXXXXXXXXXXXXXXXXXXXXXXXXXXXXXXXXXX-------y------kky-
SXXXXXXXXXXXXXXXXXXXXXXXXXXXXXXXXXXXXXXXXXXXXXXXXXX--XXXXXXXXXXXXXXXXXXXXXXXXXXXXXXXXXXXXXXXXXXXXXXXXXXXXXXXXXXXXXXXXXXXXXXXXXXXXXXXXXXXXXXXXXXXXXXXXX

