S----SSSSSSSSSSSSSSSSSSSSSSSSSSSSSSSSSSSSSSSSSSSSSSSSSSSSSSSSSSSSSSSSSSSSSSSSSSSSSSSSSSSSSSSSSSSSSSSSSSSSSSSSSSSSSSSSSSSSSSSSSSSSSSSSSSSSSSSSSSSSSSSSS
S----SSSSSSSSSSSSSSSSSSSS---------------SSSSSSSSSSSSSSSSSSSSSSSSSSSSSSSSS-------SSSSSS------SSSSSSSSSSSSSSSSSSSSSSSSSSSSSSSSSSSSSSSSSSSSSSSSSSSSSSS---
S------------SSSSSSSSSSSS---------------------SSSSSSSSSSSSSSSSSSS---------------------------SSSSSSSSSSSS-------SSSSSSS------------------SSSSS---------
S----------------------------------------------------SSSSSSSSSSSS----------------------------------------------SSSSSSS------------------SSSSS---------
S-----------------------------------------------------------------------------------------------------------------------------------------------------
S-----------------------------------------------------------------------------------------------------------------------------------------------------
S-----------------------------------------------------------------------------------------------------------------------------------------------------
S-----------------------------------------------------------------------------------------------------------------------------------------------------
S---------------ooo----------------------------------------------------------------------------------------------------------------ooo----------------
S------------------------------------------------------------------------oooooSo----------------ooSSSooo----------------------------------------------
S--------------ooo-----------oSo----------------------------------------------------ooooo----------------------------------ooSS-----oooo---oooo-------
S-------------r-k--k----------------------------------SSSSo-----ooooo-----ooooo-----------------oooooo-----------------------------g---------k--------
S------------XXXXXXXX-----oooooo--------------------------------------------g--k--XXXXXXXXX---------k-k-------XXX--XXXXXX--oooooo-XXXXXXXXXXXXXX------
SXXXXXXXXXXXXXXXXXXXX-------------------------------oooooooo----oooo---XXXXXXXXXXXXXXXXXXXX----XXXXXXXXXXX----XXXXXXXXXXX-----y---XXXXXXXXXXXXXX------
SXXXXXXXXXXXXXXXXXXXX----XXXXXXXXXXXXXXXXXX---XXXXX-k---g----XX------r-XXXXXXXXXXXXXXXXXXXX----XXXXXXXXXXX----XXXXXXXXXXXXXXXXXXXXXXXXXXXXXXXXXX------
SXXXXXXXXXXXXXXXXXXXXXXXXXXXXXXXXXXXXXXXXXX---XXXXXXXXXXXXXXXXXXXXXXXXXXXXXXXXXXXXXXXXXXXXXXXXXXXXXXXXXXXXXXXXXXXXXXXXXXXXXXXXXXXXXXXXXXXXXXXXXXXXXXXX

