S----SSSSSSSSSSSSSSSSSSSSSSSSSSSSSSSSSSSSSSSSSSSSSSSSSSSSSSSSSSSSSSSSSSSSSSSSSSSSSSSSSSSSSSSSSSSSSSSSSSSSSSSSSSSSSSSSSSSSSSSSSSSSSSSSSSSSSSSSSSSSSSSSS
S----SSSSSSS-----------------------SSSSSSSSSSSSSSSSSSSSSSSSSSSSSSSSSSSSSSSSSSSSSSSSSSSSSSSSSSSSSSSSSSSSSSSSSSSSSSSSSSSSSSSSSSSSSSSSSSSSSSSSSSSSSSSSSSS
S----SSSSSSS-----------------------SSSSSSS--------SSSSSSSSSSSSSSSSSSS-------------------SSSSSSSSSSSSSSSSSSSS------SSSSSSSSSSSSSSSSSSSSSSSSSSSSSSSSSSSS
S----SSSSSSS--------------------------------------SSSSSSSSSSSS--------------------------SSSSSSSSSSSS--------------------------------SSSSS-----SSSSSSSS
S-----------------------------------------------------------------------------------------------------------------------------------------------------
S-----------------------------------------------------------------------------------------------------------------------------------------------------
S-----------------------------------------------------------------------------------------------------------------------------------------------------
S-----------------------------------------------------------------------------------------------------------------------------------------------------
S---------------------------------------------------------oooo----------------oSo------------------------------------------------------*--------------
S------------------------------------------------------------------------------------------------SSoo----------------------------------*--------------
S---------------------------------------------------------------------------oooo-------------------------------------oooSoo------------*--*-----------
S-----------------------------------------------------*-------------------------------------------ooooo--------------------------------*--*-----------
S-------------------------------------------------XXXXXXXXXXXXX------------XXXXXXXXXXXXXXXXXXX-y-------------------ooooooooo-XX--XX---XXXXXXXX--------
S------------------XXXX-----------------*---X--X--XXXXXXXXXXXXXXXX-ooooo---XXXXXXXXXXXXXXXXXXXXXXXXXXXXXX-----------g-----ky-XX--XX---XXXXXXXX--oooo--
S------------------XXXX-rg----g---------*-XXX--XXXXXXXXXXXXXXXXXXX-Y---r---XXXXXXXXXXXXXXXXXXXXXXXXXXXXXX----XXXXXXXXXXXXXXXXXX--XX---XXXXXXXX--------
SXXXXXXXXXXXXX---XXXXXXXXXXXXXXXXXXXXXXXXXXXX--XXXXXXXXXXXXXXXXXXXXXXXXXXXXXXXXXXXXXXXXXXXXXXXXXXXXXXXXXXXXXXXXXXXXXXXXXXXXXXXX--XXXXXXXXXXXXXXXXXXXXX

