S----SSSSSSSSSSSSSSSSSSSSSSSSSSSSSSSSSSSSSSSSSSSSSSSSSSSSSSSSSSSSSSSSSSSSSSSSSSSSSSSSSSSSSSSSSSSSSSSSSSSSSSSSSSSSSSSSSSSSSSSSSSSSSSSSSSSSSSSSSSSSSSSSS
S----SSSSSSSSSSSSSSSSSSSSSS-----SSSSSSSSSSSSSSSSSSSSSSSSSS--------SSSSSSSSSSSSSSSSSSSSSSSSSSSSSSSSS--------SSSSSSSSSSSSSS-------------------SSSSSSSSSS
S----SSSSSSSSSSSSSSS------------SSSSS-----SSSSSSSSSSSSSSSS--------SSSSSSSSSSSSSSSSSSSSSSSSSSSSSSSSS--------SSSSSSSS-------------------------SSSSS-----
S----SSSSSSSS-------------------SSSSS-----SSSSSSSS----------------SSSSSSSSSSSSSSSSSSSSSSSSSSSSSSSSS--------SSSSSSSS-------------------------SSSSS-----
S-----------------------------------------------------------------------------------------------------------------------------------------------------
S-----------------------------------------------------------------------------------------------------------------------------------------------------
S-----------------------------------------------------------------------------------------------------------------------------------------------------
S-----------------------------------------------------------------------------------------------------------------------------------------------------
S---------------------------------------------------------------------------------------------------------------------------SooSo---------------------
S-----------------------------------------------------------------------------------------------------------------------------------------------------
S------------------------------------------------------Soo-------------------------ooSo---------SSSSSSo------*------------oooo------------------------
S----------------------------SooooS--------------------------------------------------------------------------*---oo-------r-------------oooo----------
S---------------X--X----XXX---------------------ooo-----ooo------------------XXXXX---ooo-XXX---oooooo--------*---Yr------XXXXXXXXX----------g---------
S--------------XX--XX---XXX--ooooo---XXXXX-------r------rr---------------XXXXXXXXX-------XXX-------------XXXXXXXXXXXXXX--XXXXXXXXXXXXXXXXXXXXXXXXXXXXX
SXXXXXXXXXXX--XXX--XXX--XXX-y--------XXXXX--XXXXXXXXXXXXXXXXXXXXXXX------XXXXXXXXXXXXXXXXXXXXXXXXXXXXXXXXXXXXXXXXXXXXXX--XXXXXXXXXXXXXXXXXXXXXXXXXXXXX
SXXXXXXXXXXXXXXXX--XXXXXXXXXXXXXXXXXXXXXXXXXXXXXXXXXXXXXXXXXXXXXXXXXXXXXXXXXXXXXXXXXXXXXXXXXXXXXXXXXXXXXXXXXXXXXXXXXXXXXXXXXXXXXXXXXXXXXXXXXXXXXXXXXXX

