S----SSSSSSSSSSSSSSSSSSSSSSSSSSSSSSSSSSSSSSSSSSSSSSSSSSSSSSSSSSSSSSSSSSSSSSSSSSSSSSSSSSSSSSSSSSSSSSSSSSSSSSSSSSSSSSSSSSSSSSSSSSSSSSSSSSSSSSSSSSSSSSSSS
S----SSSSSSSSSSSSSSSSSSSSSSSS-------SSSSSSSSSSSSSSSSSSSSSS------SSSSS------SSSSSSSSSSSSSSSSSSSSSSSSSSSSSSSSSSSSSSSSSSSSSSSSSSSSSSSSSSSSSSSSSSSSSSSSSSS
S----SSSSSSSSSSSSSSSS---------------SSSSSSSSSSSSSSSSSSSSSS------------------------------SSSSSSSSSSSSSSSSSSSSSSSSSSSSSSSSSSSSSSSSS--------SSSSSSS------
S----SSSSSSSS-----------------------SSSSSSSS------SSSSSSSS-------------------------------------SSSSSSSSSSSSSSSSSSSSSSS-----SSSSSS---------------------
S-----------------------------------------------------------------------------------------------------------------------------------------------------
S-----------------------------------------------------------------------------------------------------------------------------------------------------
S-----------------------------------------------------------------------------------------------------------------------------------------------------
S-----------------------------------------------------------------------------------------------------------------------------------------------------
S------------oSSo-------------------------------------------------------------------------------------------------------------------------------------
S-------------------------------------------------------------------------------------------------------------------------------------------oooS------
S-------------ooooo-------------ooo--------------------------------------*---------oSooo--------------------------------------------------------------
S----------------------oSS-----------------------------Tt----------RG----*-----------------------------------------oooSooo----------------ooooo-------
S-----------XXXXXXXXX----------oo--------X--X----------Tt---tt--XXXXXX---*-----------oooooo---------XXXXXXXXXXXXXX-------------Tt--tt-------k---------
S-----------XXXXXXXXX----oo-------------XX--XX---XXXX--Tt---tt--XXXXXXXXXXXX--------------g-XXX--XXXXXXXXXXXXXXXXX--oooo-------Tt--tt---XXXXXXXXXX---X
SXXXXXXXXXXXXXXXXXXXX--y-----XXXXXXXX--XXX--XXX--XXXXXXXXXXXXXXXXXXXXXXXXXXXXXXXXXXXXXXXXXXXXXX--XXXXXXXXXXXXXXXXX----g----XXXXXXXXXXXXXXXXXXXXXXX---X
SXXXXXXXXXXXXXXXXXXXXXXXXXXXXXXXXXXXXXXXXX--XXXXXXXXXXXXXXXXXXXXXXXXXXXXXXXXXXXXXXXXXXXXXXXXXXX--XXXXXXXXXXXXXXXXXXXXXXXXXXXXXXXXXXXXXXXXXXXXXXXXXXXXX

