S----SSSSSSSSSSSSSSSSSSSSSSSSSSSSSSSSSSSSSSSSSSSSSSSSSSSSSSSSSSSSSSSSSSSSSSSSSSSSSSSSSSSSSSSSSSSSSSSSSSSSSSSSSSSSSSSSSSSSSSSSSSSSSSSSSSSSSSSSSSSSSSSSS
S----SSSSSSSSSSSSSSSSSSSSSSSSSSSSSSS-------SSSSSSSS------SSSSSSSSSSSSSSS------SSSSSSSSSSSSSSSSSSSSSSSSSSSSSSSSSSSSSSSSSSSSSSSSSSSSSSSSSSSSSSSSSSSSSSS-
S----SSSSS--------------SSSSSSSSSSSS-------SSSSSSSS--------------SSSSSSS------SSSSSSSSSSS--------SSSSSSSSSSSSSSSSSSSSSS--------SSSSSSSS-------SSSSSSS-
S-----------------------SSSSS-------------------------------------------------------SSSSS--------SSSSSSSSSSSSSSSSSSSSSS--------SSSSSSSS---------------
S-----------------------------------------------------------------------------------------------------------------------------------------------------
S-----------------------------------------------------------------------------------------------------------------------------------------------------
S-----------------------------------------------------------------------------------------------------------------------------------------------------
S-----------------------------------------------------------------------------------------------------------------------------------------------------
S---------------------------------------------------------------------------------------------------------ooSS----------------------oSSoSo------------
S-------------------------------------------------------------------------------------------------------------------------ooSoo-----------------------
S-----------------------------------------------------ooo-------------------------------oooSS------ooo----ooooo---------------------ooooo-------------
S-------------oSoSoS------Sooo-------------------------------------------------------------------------------------------oooooooo----k-r--------------
S----------------------------------------------------XXXXXXX-----XX----XXXXXX--XXXXXXXX------------------XXXXXXX------------r-----XXXXXXXXX-----------
SXXXXXXXXXXXX----ooooo---ooo------oo--k--g------XXXXXXXXXXXX-----XXXXXXXXXXXXXXXXXXXXXX------------------XXXXXXX----oo--XXXXXXXXXXXXXXXXXXX-----------
SXXXXXXXXXXXX-rr-k-g-g------k---k----XXXXXXXXXXXXXXXXXXXXXXX-----XXXXXXXXXXXXXXXXXXXXXXXXXXXXXXXXXXXXXX--XXXXXXX--------XXXXXXXXXXXXXXXXXXX-----------
SXXXXXXXXXXXXXXXXXXXXXXXXXXXXXXXXXXXXXXXXXXXXXXXXXXXXXXXXXXXXXXXXXXXXXXXXXXXXXXXXXXXXXXXXXXXXXXXXXXXXXXXXXXXXXXXXXXXXXXXXXXXXXXXXXXXXXXXXXXXXXXXXXXXXX

