S----SSSSSSSSSSSSSSSSSSSSSSSSSSSSSSSSSSSSSSSSSSSSSSSSSSSSSSSSSSSSSSSSSSSSSSSSSSSSSSSSSSSSSSSSSSSSSSSSSSSSSSSSSSSSSSSSSSSSSSSSSSSSSSSSSSSSSSSSSSSSSSSSS
S----SSSSSSSSSSSSSSSSSSSSSSSSSSSSSSSSSSSSSSSSSSSSSSSSSSSSSSSSSSSSSSSSSSSSSSSSSSSSSSSSSSS-------SSSSSSSSSSSSSSSSSSSSSSSSSSSSSSSSSSSSSSSSSSSSSSSSSSSSSSS
S----SSSSSSSSSSSSSSS------SSSSS--------SSSSSSSSSSSSSSSSSSSSSS--------SSSSSSSSSSSSSS------------SSSSSS---------------------------SSSSSSSSSSSSS------SSS
S------------SSSSSSS-------------------------------------------------SSSSSSSSSSSSSS-------------------------------------------------------------------
S-----------------------------------------------------------------------------------------------------------------------------------------------------
S-----------------------------------------------------------------------------------------------------------------------------------------------------
S-----------------------------------------------------------------------------------------------------------------------------------------------------
S-----------------------------------------------------------------------------------------------------------------------------------------------------
S---------------oooooo--------------------------------------------------------------------------------oooo--------------------------------------------
S---------------------------oSooooS--------------------------------------oooooo-----------------------------ooooo--------Sooooo-----------------------
S-----------------oooo------------------------ooSo----------------------------------------------------oo----------------------------------------------
S--------------y------------ooooooo-------------------ooooo-------oSS------oo--------tt---Tt------------k---ooooo-----ooooooooo-----------------------
SXXXXXXXXXXXXXXXXXXXXXXXX----k---------kr-r-----oo-----k-r------------------y--------tt---Tt----XXXXXXXXXXX---R--y------------k-----------------------
SXXXXXXXXXXXXXXXXXXXXXXXXXXXXXXXXXXXXXXXXXXXX--g-----XXXXXXX------ooooo-XXXXXXXX-----tt---Tt----XXXXXXXXXXXXXXXXXXXXXXXXXXXXXXXX----------------------
SXXXXXXXXXXXXXXXXXXXXXXXXXXXXXXXXXXXXXXXXXXXXXXXXXXXXXXXXXXXXXXXX-----g-XXXXXXXXXXXXXXXXXXXXXXXXXXXXXXXXXXXXXXXXXXXXXXXXXXXXXXXX----XXX------XXXXXXXXX
SXXXXXXXXXXXXXXXXXXXXXXXXXXXXXXXXXXXXXXXXXXXXXXXXXXXXXXXXXXXXXXXXXXXXXXXXXXXXXXXXXXXXXXXXXXXXXXXXXXXXXXXXXXXXXXXXXXXXXXXXXXXXXXXXXXXXXXXXXXXXXXXXXXXXX

