S----SSSSSSSSSSSSSSSSSSSSSSSSSSSSSSSSSSSSSSSSSSSSSSSSSSSSSSSSSSSSSSSSSSSSSSSSSSSSSSSSSSSSSSSSSSSSSSSSSSSSSSSSSSSSSSSSSSSSSSSSSSSSSSSSSSSSSSSSSSSSSSSSS
S----SSSSSSSSSSSS-------SSSSS-----SSSSS-------SSSSS------SSSSSSSSSSSSSSSSSSSS-----SSSSSSSSSSSSSSSSSSSSSSSSSSSSSSSSSSSSSSSSSSSSSSSS------SSSSSSSSSSSSSS
S-----------------------SSSSS-----SSSSS------------------SSSSSSSSSSSSSSSSSSSS-----SSSSS-------SSSSSSSSSSSSSSSSSSSSSSSSSSSSSSSSSSSS--------------SSSSSS
S---------------------------------SSSSS--------------------------SSSSSSSSSSSS-----SSSSS------------SSSSSSSSSSSS------SSSSSSSSSSSSS--------------SSSSSS
S-----------------------------------------------------------------------------------------------------------------------------------------------------
S-----------------------------------------------------------------------------------------------------------------------------------------------------
S-----------------------------------------------------------------------------------------------------------------------------------------------------
S-----------------------------------------------------------------------------------------------------------------------------------------------------
S--------------------------------------------------------oSoo------ooo---------------------------------ooS--------------------------------------------
S---------------------------------Soo---------------------------------------------------------------------------------------------------SoSoo---------
S--------------------------------------------------------oooo-----oo--------oooooo---SSSSo-------------ooo---oSoSooSoo--------------------------------
S-------------------------oSSS-----ooooo-------------------r--------g-------------------------------------r--------------SoSSo-------oooooo-----------
S-----------XXXXX-----------------------------------XXXXXXXXXXXXXXXXXXX------ooo----oooooo----------XXXXXXXX---oooo-------------------y-k-------------
S-----------XXXXX-----k---oo----XXXXXXXXXXXXXXXXXXXXXXXXXXXXXXXXXXXXXXX-----g---y---g-k--------XXXXXXXXXXXXX------------ooooooo-----XXXXXXXXXXX-------
SXXXXXXXXXXXXXXXXXXXXXXX--------XXXXXXXXXXXXXXXXXXXXXXXXXXXXXXXXXXXXXXXXXXXXXXXXXXXXXXXXXXXX---XXXXXXXXXXXXXXXXXXXXXXXX----------XXXXXXXXXXXXXXXX-----
SXXXXXXXXXXXXXXXXXXXXXXXXXXXXXXXXXXXXXXXXXXXXXXXXXXXXXXXXXXXXXXXXXXXXXXXXXXXXXXXXXXXXXXXXXXXXXXXXXXXXXXXXXXXXXXXXXXXXXXXXXXXXXXXXXXXXXXXXXXXXXXXXXXXXX

