S----SSSSSSSSSSSSSSSSSSSSSSSSSSSSSSSSSSSSSSSSSSSSSSSSSSSSSSSSSSSSSSSSSSSSSSSSSSSSSSSSSSSSSSSSSSSSSSSSSSSSSSSSSSSSSSSSSSSSSSSSSSSSSSSSSSSSSSSSSSSSSSSSS
S----SSSSSSSSSSSSSSSSSSSS--------------SSSSSSSSSSSSSSS------SSSSSSSSSSSSSSSSSSSS-------SSSSSSSSSSSSSSSSSS-----SSSSSSSSSSSSSSS-------SSSSSSSSSSSSSSSSSS
S-----------SSSSSSSSSSSSS--------------SSSSSSSSSSSSSSS------------SSSSSSSS-------------------SSSSSSSSSSSS-----SSSSSSSSSSSSSSS-------SSSSSSSSSSSSSSSSSS
S-----------SSSSSSSSSSSSS-----------------------------------------SSSSSSSS------------------------SSSSSSS----------SSSSS------------------SSSSSSSSSSSS
S-----------------------------------------------------------------------------------------------------------------------------------------------------
S-----------------------------------------------------------------------------------------------------------------------------------------------------
S-----------------------------------------------------------------------------------------------------------------------------------------------------
S-----------------------------------------------------------------------------------------------------------------------------------------------------
S----------------------------------------------------------------oSoSS---------------------------------------------------------------SooooSS---oooo---
S-------------oooS---------------ooooS--------------------------------------------------------SSoSo---------------------------------------------------
S-----------------------tt---------------------------------------oooooo-------------------------------------oSSooooo-----ooo--------oooooooo----oooo--
S--------------oo-------tt-------ooo--------------------oooooo---y--r-----------------------------------------------------------------y----k---k------
SXXXXXXXXXXX-rk------XXXXXXXXXX--------------------------------XXXXXXXXXX-----------XX------------------------ooo------------------XXXXXXXXXXXXXXXXXXX
SXXXXXXXXXXXXXXXXXXXXXXXXXXXXXXXXXXXXXXXXXXX--XXXXXXX----oooo--XXXXXXXXXX-----oooo--XXXXXXXXXXXXXXXX--oooo--------------r--k----XXXXXXXXXXXXXXXXXXXXXX
SXXXXXXXXXXXXXXXXXXXXXXXXXXXXXXXXXXXXXXXXXXX--XXXXXXX-y------g-XXXXXXXXXXXXXX-------XXXXXXXXXXXXXXXX---g---XXXXXXXXXXXXXXXXXXXXXXXXXXXXXXXXXXXXXXXXXXX
SXXXXXXXXXXXXXXXXXXXXXXXXXXXXXXXXXXXXXXXXXXX--XXXXXXXXXXXXXXXXXXXXXXXXXXXXXXXXXXXXXXXXXXXXXXXXXXXXXXXXXXXXXXXXXXXXXXXXXXXXXXXXXXXXXXXXXXXXXXXXXXXXXXXX

