S----SSSSSSSSSSSSSSSSSSSSSSSSSSSSSSSSSSSSSSSSSSSSSSSSSSSSSSSSSSSSSSSSSSSSSSSSSSSSSSSSSSSSSSSSSSSSSSSSSSSSSSSSSSSSSSSSSSSSSSSSSSSSSSSSSSSSSSSSSSSSSSSSS
S----SSSSSSSSSSSSSSSSSSSSSSSSSSSSSSSSSSSS-------SSSSSSSSSSSSSSSSSSSSSSSSSSSS------------SSSSSS------SSSSSSSSSSSSSSSSSSSSSSSSSSSSSSSSSSSSSSSSSSSSSSSSSS
S----SSSSSSSSSSSSSSSSSSSSSSSSSSSSSSS------------SSSSS-----SSSSSSSSSSSSS-----------------------------SSSSSSSSSSSSSSSSSSSSSSSSSSSSS--------SSSSSSSS-----
S-----------------------SSSSSSSSSSSS------------SSSSS-----SSSSSSS-----------------------------------------SSSSSSSSSSS---------------------------------
S-----------------------------------------------------------------------------------------------------------------------------------------------------
S-----------------------------------------------------------------------------------------------------------------------------------------------------
S-----------------------------------------------------------------------------------------------------------------------------------------------------
S-----------------------------------------------------------------------------------------------------------------------------------------------------
S-------------------------------------------------------------------------------------------------oSooo-------------------SoSoS-------------ooooo-----
S------------------------------------------oSSo-----------------------------------------oSooS----------------oSoSo-------------------ooooo------------
S--------------------------------------------------------------------------------------------------ooooo-----------------oooooo--------------oo-------
S--------------ooo------ooSoo--------------ooooo--------------oSoo------------------------oo--------g--y-----oooooo----G------------oooo--------------
S---------------------------------------------g--------------------------------XX------g--------XXXXXXXXXX------------XXXXXXXXXXXXX--------XXXXXXX----
S------------XXXXXXXX----oooo--XXX---XXXXXXXXXXXX-----------ooooo-----------XXXXXXXXXXXXXXXXXXXXXXXXXXXXXX--XXXXXXXXXXXXXXXXXXXXXXXXXXXXXXXXXXXXXXXXXX
SXXXXXXXXXXXXXXXXXXXX-----k--y-XXX---XXXXXXXXXXXX----XXXXXX-----y---XXX--XXXXXXXXXXXXXXXXXXXXXXXXXXXXXXXXXXXXXXXXXXXXXXXXXXXXXXXXXXXXXXXXXXXXXXXXXXXXX
SXXXXXXXXXXXXXXXXXXXXXXXXXXXXXXXXX---XXXXXXXXXXXXXXXXXXXXXXXXXXXXXXXXXX--XXXXXXXXXXXXXXXXXXXXXXXXXXXXXXXXXXXXXXXXXXXXXXXXXXXXXXXXXXXXXXXXXXXXXXXXXXXXX

