----------------------------------------------------------------------------------------------------------------------------------------------------------------
----------------------------------------------------------------------------------------------------------------------------------------------------------------
-------------------------------------------------------------SSS!-----------------------------------------------------------------------------------------------
----------------------------------------------------------------------------------------------------------------------------------------------------------------
---------SSSSS---SSS!----------------------------------------------------------------------------------------------------------------------------SSSSS----------
----------------------------------------------------------------------------------------------------------------------------------------------------------------
----------------------------------------------------------------------------------------------------------------------------------------------------------------
-----------------------------------------------------------------##------1--------------------------------------------------------------------------------------
--------------------C------tt-------##----------------##---------##--------------------------------------------------------##--------------SSSSS----------------
--------#####--------------tt------###---------------###---------##-------------------------------------------------------###-------------------#####------1----
-tt----######--------------tt-----####-------------S-------------------------------------tt------SU----SS------#--#------####------!---SU------######-----------
-tt---#######--------------tt----#####-#######-----------------------tt------------------tt-------------------##--##--------------------------#######-----------
-tt---#######---X---XXXXXXXXXXXXXXXXXX-XXXXXXXXXXXX------------------tt------------------tt------------------###--###-------------------------#######-----------
-M--------------X---XXXXXXXXXXXXXXXXXX-XXXXXXXXXXXX------gg----------tt-g-----------gg-#######-------g-g----####--####------------------------------------------
XXXXXXXXXXXXX--------------------------------------XXXXXXXXXXXXXXXXXXXXXXXX---XXXXXXXXXXXXXXXXXXXXXXXXXXXXXXXXXXXXXXXXXXX---XXXXXXXXXXXXXXXXXXXXXXXXX-----------
XXXXXXXXXXXXX--------------------------------------XXXXXXXXXXXXXXXXXXXXXXXX---XXXXXXXXXXXXXXXXXXXXXXXXXXXXXXXXXXXXXXXXXXX---XXXXXXXXXXXXXXXXXXXXXXXXX-----------
