--------------------------------------------------------------------------------------------------------------------------------------------------------------------------
--------------------------------------------------------------------------------------------------------------------------------------------------------------------------
--------------------------------------------------------------------------------------------------------------------------------------------------------------------------
--------------------------------------------------------------------------------------------------------------------------------------------------------------------------
--------------------------------------------------------------------------------------------------------------------------------------SSSSS---SSS!------------------------
--------------------------------------------------------------------------------------------------------------------------------------------------------------------------
-----SSS!-------------------------------------------------------------------------------------------tt------------------------------------------------------tt------------
----------------------------------------------------------------------------------------------------tt------------------------------------------------------tt------------
---------------SSSSS--------------------------------------------------------------------------------tt---------------------------------------------SSS!-----tt------------
-----------------------------------------------------------------------------------------------------#----------1----------------------------###----------#####------1----
--------C----------------------S@S!S-------##-----------##------------!-----#--#--------------------##--#-----------------SS------#--#------####---------######-----------
------------------------------------------###----------###-----tt----------##--##------------------###--##-----------------------##--##----#####--------#######-----------
------------------------XTT--------------####---------####-----tt---------###--###----------tt-#---###--###---------------------###--###---#####------C-#######-----------
-M-------g-g--#######----tt-----g-------#####---gg---#####-----tt-g---k--####--####----gg---tt##--------####--#######---g-g----####--####--#######------------------------
XXXXXXXXXXXXXXXXXXXXXXXXXXXXXXXXXXXXXXXXXXXXX-XXXXXXXXXXXX-XXXXXXXXXXXXXXXXXXXXXXXXXXXXXXXXXXXXXXXXXXXXXXXXXXXXXXXXXXXXXXXXXXXXXXXXXXXXXXXXXXXXXXXXXXXXXXXXXXXX-----------
XXXXXXXXXXXXXXXXXXXXXXXXXXXXXXXXXXXXXXXXXXXXX-XXXXXXXXXXXX-XXXXXXXXXXXXXXXXXXXXXXXXXXXXXXXXXXXXXXXXXXXXXXXXXXXXXXXXXXXXXXXXXXXXXXXXXXXXXXXXXXXXXXXXXXXXXXXXXXXX-----------
