---------------------------------------------------------------------------------------------------------------------------------------------------------------------------------------
---------------------------------------------------------------------------------------------------------------------------------------------------------------------------------------
---------------------------------------------------------------------------------------------------------------------------------------------------------------------------------------
---------------------------------------------------------------------------------------------------------------------------------------------------------------------------------------
---------------------------------------------------------------------------------------------------------------------------------------------------------------------------------------
---------------------------------------------------------1-----------------------------------------------------------------------------------------------------------------------------
---------------------------------------------------------------------------------------------------------------------------------------------------------------------------------------
---------------------------------------g------------------------------------------------1----------------------------------------------------------------------------------------------
-------------------------------------SSSSSSSS------------------------------------------------------------------------------------------------------------------------------------------
---------------------------------------------------#####--##---------1-----------------------------------------------------------------------------------------------------------------
-----SS!S----------------SS!S---!---g-------------######-###---!--------------------------------------S@S!S-------------------tt------------------#-----------------!--------------tt--
-------------------------------------------------###########------------------------------------------------------------------tt------------tt----##-------------------------------tt--
----------------------------------S@S---------XTT###########------------------------------------------------------------------tt------------tt----###--tt-XTT----------------------tt--
-M---------gg----g-g-tt-------------#######----tt------------------#######-----g-g----gg---------------g------------gg----g-g-tt------------tt-g--####-tt--tt----------------------tt--
XXXXXXXXXXXXXXXXXXXXXXXXXXXXXXXXXXXXXXXXXXXXXXXXXXXXXXXXXXXXXXXXXXXXXXXXXXXXXXXXXXXXXXXXXX---XXXXXXXXXXXXXXXXXXXXXXXXXXXXXXXXXXXX---XXXXXXXXXXXXX-XXXXXXXXXXXXXXXXXXXXXXX---XXXXXXXXXXX
XXXXXXXXXXXXXXXXXXXXXXXXXXXXXXXXXXXXXXXXXXXXXXXXXXXXXXXXXXXXXXXXXXXXXXXXXXXXXXXXXXXXXXXXXX---XXXXXXXXXXXXXXXXXXXXXXXXXXXXXXXXXXXX---XXXXXXXXXXXXX-XXXXXXXXXXXXXXXXXXXXXXX---XXXXXXXXXXX
