-------------------------------------------------------------------------------------------------------------------------------------------------------
-------------------------------------------------------------------------------------------------------------------------------------------------------
-------------------------------------------------------------------------------------------------------------------------------------------------------
-------------------------------------------------------------------------------------------------------------------------------------------------------
-------------------------------------------------------------------------------------------------------------------------------------------------------
-------------------------------------------------------------------------------------------------------------------------------------------------------
-SSSSS---SSS!-----------------------------------------------------------------------tt-----------------------------------------------------------------
------------------------------------------------------------------------------------tt-----------------------------------------------------------------
--------------------SSS!------------------------tt-------------------SSSSS---SSS----tt-------------SSSSS---SSS!----------------------------------------
-----------------------------------1------------tt-------------#####--------------#####----------------------------------------------------------------
------------C---------------tt-------------S----tt-------tt---######-------------######------------------------------!---#-------SS!S-------tt---------
------------##--------------tt---------------------------tt--#######------------#######----------------------------------##-----------------tt---------
------------###--------C----tt---------------------------tt--#######------------#######-----------------------C----------###-----------t----tt---------
-M----------####-tt--------------#######---------g-g-----tt---------------------------------gg-----------#######-----k---####----------tt##------------
XXXX---XXXX-XXXXXXXXXXXXXXXXXX---XXXXXXXXXXXXXXXXXXXXXXXXXXXXXXXXXXXXXXXXXX--XXXXXXXXXX---XXXXXXXXXXXXXXXXXXXXXXXXXXXXXXXXXXXXXXXXXXXXXXXXXXXXXXXXXXX--
XXXX---XXXX-XXXXXXXXXXXXXXXXXX---XXXXXXXXXXXXXXXXXXXXXXXXXXXXXXXXXXXXXXXXXX--XXXXXXXXXX---XXXXXXXXXXXXXXXXXXXXXXXXXXXXXXXXXXXXXXXXXXXXXXXXXXXXXXXXXXX--
