--------------------------------------------------------------------------------------------------------------------------------------------------------------------------
--------------------------------------------------------------------------------------------------------------------------------------------------------------------------
--------------------------------------------------------------------------------------------------------------------------------------------------------------------------
--------------------------------------------------------------------------------------------------------------------------------------------------------------------------
--------------------------------------------------------------------------------------------------------------------------------------------------------------------------
--------------------------------------------------------1-----------------------------------------------------------------------------------------------------------------
--------------------------------------------------------------------------------------tt----------------tt----------------------------------------------------------------
--------------------------------------------------------------------------------------tt----------------tt----------------------------------------------------------------
-------------------------------------------SSS!---------------------------SSSSS-------tt----------------tt----------------------------------------------------------------
---------------------------------------------------------#####------1------------------#####-------------##---------1-----------------------------------------------------
---S@S!S----SS!S---tt-------SU--S@S!S--S-----------tt---######------------------------######--#---------###---!-------------------------------!-----!---#-----------------
-------------------tt------------------------------tt--#######-----------------------#######--##-------####---------------------------tt----------------##----------------
-------------------tt-------------------------C----tt--#######-----------------------#######--###------####-------------------tt-#----tt----------------###---------------
-M--g--------------tt----gg------g---------------------#######--------------------------------####----------------#######-----tt##----tt-g----------k---####--------------
XXXXXXXXXXXXXXXXXXXXXXXXXXXXXXXXXXXXXXXXXXXXXXXXXXXXX--XXXXXXXXXX-----XXXXXXXXXX--XXXXXXXXXXXXXXXXXXXXXXXXXXXXXXXXXXXXXXXXXXXXXXXXXXXXXXXXXXXXXXXXXXXXXXXXXXXXXXXXXXXXXX--
XXXXXXXXXXXXXXXXXXXXXXXXXXXXXXXXXXXXXXXXXXXXXXXXXXXXX--XXXXXXXXXX-----XXXXXXXXXX--XXXXXXXXXXXXXXXXXXXXXXXXXXXXXXXXXXXXXXXXXXXXXXXXXXXXXXXXXXXXXXXXXXXXXXXXXXXXXXXXXXXXXX--
