-----------------------------------------------------------------------------------------------------------------------------------------------------------------------------
-----------------------------------------------------------------------------------------------------------------------------------------------------------------------------
-----------------------------------------------------------------------------------------------------------------------------------------------------------------------------
---------------------------------------------------------------------------------------------------------------------------------------g-------------------------------------
-------------------------------------------------------------------------------------------------------------------------------------SSSSSSSS---SSS!-------------------------
-----------------------------------------------------------------------------------------------------------------------------------------------------------------------------
------------------------------------------------------------------------------------------------------------------------------------g----------------------------------------
-----------------------------------------------------------------------------------------------------------------------1-----------------------------------------------------
----------------------------------------------------------------------------------------------------------------------------------S@S--------------C-------------------------
-----------------------------------------------------------------------------------------------------------------------------------------------#####------1------------------
----#---------SS----#-------!-----#--#-------SS------#--#---------------tt-----SS!S----------SU-----tt---------------------------XXXXXXXXXX---######--------------SU-----!---
----##--------------##-----------##--##-------------##--##--------------tt--------------------------tt------tt------tt-----------XXXXXXXXXX--#######-------------------------
----###--tt---------###---------###--###-----------###--###-----tt-#----tt--------------------------tt------tt------tt------------tt---------#######-------------------------
-M--####-tt-g-g-----####----k--####--####--g-g----####--####----tt##---g-g-tt--------gg-------------tt------tt-g----tt----------#######-----------------#######--------------
XXX-XXXXXXXXXXXXXXXXXXXXXXXXXXXXXXXXXXXXXXXXXXXXXXXXXXXXXXXXXXXXXXXXXXXXXXXXXXXXXXXXXXXXXXXXXXXXXXXXXXXXXXXXXXXXXXXXXXXXX---XXXXXXXXXXXXXXXXXXXXXXXX----XXXXXXXXXXXXXXXXXXXXX
XXX-XXXXXXXXXXXXXXXXXXXXXXXXXXXXXXXXXXXXXXXXXXXXXXXXXXXXXXXXXXXXXXXXXXXXXXXXXXXXXXXXXXXXXXXXXXXXXXXXXXXXXXXXXXXXXXXXXXXXX---XXXXXXXXXXXXXXXXXXXXXXXX----XXXXXXXXXXXXXXXXXXXXX
