---------------------------------------------------------------------------------------------------------------------------------------SSS!---------------------------------
----------------------------------------------------------------------------------------------------------------------------------------------------------------------------
----------------------------------------------------------------------------------------------------------------------------------------------------------------------------
----------------------------------------------------------------------------------------------------------------------------------------------------------------------------
-----------------------------------------------------------------------------------------------------------------------SSSSS---SSS!-------C---------------------------------
--------------------------------------------------------------------------------------------------------------------------------------#####------1-----------------1--------
-------------------------------------------------------------------------------------------------------------------------------------######---------------------------------
------------------------------------------------------------------------------------------------------------------------------------#######---------------------------------
-----------------------------------------------------------------------------------------------------tt----SSS!-------------------C-#####S------------------SS!S------------
-----------------------------------------------------------------------------------------------------tt------------------#####----------------------------------------------
-----------------------------SS------#--#--------!-----SS!S---------S@S!S--------#-------------------tt------------tt---######---XXXXXXXX-----------------------------------
-------tt-------------tt------------##--##---------------------tt----------------##-------------###----------------tt--#######---XXXXXXXX------gg---------------------------
-------tt-----tt-#----tt-----------###--###--------------------tt----------------###-----tt----####-----------C----tt--#######-----------XXXXXXXXXX---XXXXXXXXXXXXXXX---XXXX
-M-----tt-g---tt##----tt-g-g-g----####--####-------------------tt-g--g-------gg--####----tt---#####---g-g--------------------------------XXXXXXXXXX---XXXXXXXXXXXXXXX---XXXX
XXXXXXXXXXXXXXXXXXXXXXXXXXXXXXXXXXXXXXXXXXXXXXXXXXXXXXXXXXXXXXXXXXXXXXXXXXXXXXXX-XXXXXXXXXXXXXXXXXX-XXXXXXXXXXXXXXXXX-------------------------------------------------------
XXXXXXXXXXXXXXXXXXXXXXXXXXXXXXXXXXXXXXXXXXXXXXXXXXXXXXXXXXXXXXXXXXXXXXXXXXXXXXXX-XXXXXXXXXXXXXXXXXX-XXXXXXXXXXXXXXXXX-------------------------------------------------------
