-----------------------------------------------------------------------------------------------------------------------------------------------------------------------------------
-----------------------------------------------------------------------------------------------------------------------------------------------------------------------------------
-----------------------------------------------------------------------------------------------------------------------------------------------------------------------------------
-----------------------------------------------------------------------------------------------------------------------------------------------------------------------------------
-----------------------------------------------------------------------------------------------------------------------------------------------------------------------------------
-----------------------------------------------------------------------------------------------------------------------------------------------------------------------------------
--------------------------------------------------------------------------------------------------------------SSSSS---SSS!----------------------------------------------##---------
-----------------------------------------------------------------------------------------------------------------------------------------------------------------------###---------
----------------------------------------------------------------------------tt----------------------------------------------------------------------------------------####---------
----------------------------------------------------------------------1-----tt---------------------------------------------------------------------------------------#####---------
------tt-------------SS!S--------SS!S--SS----#------------#---!-------------tt---------##---!---#-------tt---------------C---------!-----#--#-------!-----#--#------######-----SS!S
------tt------tt-----------------------------##-----------#---------------------------###-------##------tt------------------tt----------##--##-----------##--##----#######---------
------tt------tt-----------tt-#--------------###-----tt-#-#--------------------------####-------###-----tt------------------tt---------###--###---------###--###---#######---------
-M----tt------tt-g---------tt##------g-g-----####----tt##-#----------g-g-tt--g-g----#####---k---####--#######---------------tt-g---k--####--####----k--####--####--#######---------
XXXXXXXXXXXXXXXXXXXXXXXXXXXXXXXXXXXXXXXXXXXXXXXXXXXXXXXXX-XXXXXXXXXXXXXXXXXXXXXXXXXXXXXXX-XXXXXXXXXXXXXXXXXXXXXXX---XXXXXXXXXXXXXXXXXXXXXXXXXXXXXXXXXXXXXXXXXXXXXXXXXXXXXXXXXXXXXXX
XXXXXXXXXXXXXXXXXXXXXXXXXXXXXXXXXXXXXXXXXXXXXXXXXXXXXXXXX-XXXXXXXXXXXXXXXXXXXXXXXXXXXXXXX-XXXXXXXXXXXXXXXXXXXXXXX---XXXXXXXXXXXXXXXXXXXXXXXXXXXXXXXXXXXXXXXXXXXXXXXXXXXXXXXXXXXXXXX
