------------------------------------------------------------------------------------------------------------------------------------------------------------------------------------------
------------------------------------------------------------------------------------------------------------------------------------------------------------------------------------------
------------------------------------------------------------------------------------------------------------------------------------------------------------------------------------------
------------------------------------------------------------------------------------------------------------------------------------------------------------------------------------------
-----------------------------------------------------------------------------------------------------------------------------------------------SSS!---------------------------------------
------------------------------------------------------------------------------------------------------------------------------------------------------------------------------------------
-------------------------------------------------------------------------------------------------------------------------SSS!--------------------------------------##---------------------
------------------------------------------------------------------------------------------------------------------------------------------------------------------###---------------------
--------------------------------------------------------------------------------------------------------------------------------------------------C--------------####---------------------
------------------------------------------------------------------------------------------------------------------------------------------------#####-----------#####------1--------------
---------------!-----#--#-------SS----#--------------SS------#--#------------SS!S-#-----------------##---SS!S---------------C-------##------------###-----tt---######---------------------
--------------------##--##------------##--------------------##--##----------------##---------------###----------------tt-----------###-------tt---###-----tt--#######---------------------
-------------------###--###-----------###---XTT------------###--###---------------###--tt---------####----------------tt----------####-------tt---###-----tt--#######---------------------
-M-#######-----k--####--####--g-g-----####---tt----g-g----####--####--------------####-tt--------#####----------------tt-g---g-g-------------tt-g-------------------------g-g-tt#######---
XXXXXXXXXXXXXXXXXXXXXXXXXXXXXXXXXXXXXXXXXXXXXXXXXXXXXXXXXXXXXXXXXXXXXXXXXXXXXXXXX-XXXXXXXXXXXXXXXXXXXX-XXXXXXXXXXXXXXXXXXXXXXXXXXXXXXXXXXXXXXXXXXXXXXXXXXXXX-----------XXXXXXXXXXXXXXXXXXX
XXXXXXXXXXXXXXXXXXXXXXXXXXXXXXXXXXXXXXXXXXXXXXXXXXXXXXXXXXXXXXXXXXXXXXXXXXXXXXXXX-XXXXXXXXXXXXXXXXXXXX-XXXXXXXXXXXXXXXXXXXXXXXXXXXXXXXXXXXXXXXXXXXXXXXXXXXXX-----------XXXXXXXXXXXXXXXXXXX
