---------------------------------------------------------------------------------------------------------------------------------------------------------------------------------
---------------------------------------------------------------------------------------------------------------------------------------------------------------------------------
---------------------------------------------------------------------------------------------------------------------------------------------------------------------------------
---------------------------------------------------------------------------------------------------------------------------------------------------------------------------------
---------------------------------------------------------------------------------------------------------------------------------------------------------------------------------
---------------------------------------------------------------------------------------------------------------------------------------------------------------------------------
-----------------------------------------------------SSS!--------------------------------SSS!------------------------------------------------------------------------------------
---------------------------------------------------------------------------------------------------------------------------------------------------------------------------------
------SSSSS-----------------SSSSS---SSS!-----------------------------------------------------------------------------------------------------------------------------------------
------------------------------------------------------------------------------------------------------1--------------------------------------------------------------------------
--------------!---#----------------------------##-------C------#---------SS------#--#-------C---------------#----------------S@S!S--SU----------SS----#------#-------------------
------------------##--------------------------###--------------##---------------##--##----------------------##----------------------------------------##-----##------------------
------------------###------------------C-----####--------------###--tt---------###--###---------------------###-----tt---tt-#-------------tt-#--------###----###--tt-------------
-M----g-g-tt--k---####----------#######-----#####--------------####-tt-g-g----####--####-------------g-g-tt-####----tt---tt##-g-----------tt##g-g-----####---####-tt-------------
XXXXXXXXXXXXXXXXXXXXXXXXXXXXXXXXXXXXXXXXXXXXXXXXX-XXXXX---XXXX-XXXXXXXXXXXXXXXXXXXXXXXXXXXX---XXXXXXXXXXXXX-XXXXXXXXXXXXXXXXXXXXXXXXXXXXXXXXXXXXXXXXXXXXXXXX-XXXXXXXXXXXXXXXXXX--
XXXXXXXXXXXXXXXXXXXXXXXXXXXXXXXXXXXXXXXXXXXXXXXXX-XXXXX---XXXX-XXXXXXXXXXXXXXXXXXXXXXXXXXXX---XXXXXXXXXXXXX-XXXXXXXXXXXXXXXXXXXXXXXXXXXXXXXXXXXXXXXXXXXXXXXX-XXXXXXXXXXXXXXXXXX--
