---------------------------------------------------------------------------------------------------------------------------------------------------------------------------------------
---------------------------------------------------------------------------------------------------------------------------------------------------------------------------------------
---------------------------------------------------------------------------------------------------------------------------------------------------------------------------------------
---------------------------------------------------------------------------------------------------------------------------------------------------------------------------------------
---------------------------------------------------------------------------------------------------------------------------------------------------------------------------------------
---------------------------------------------------------------------------------------------------------------------------------------------------------------------------------------
-------------SSS!-------------------------------------------------tt-------------------------------------------SSS!----------------------SSS!------------------------------------------
------------------------------------------------------------------tt-------------------------------------------------------------------------------------------------------------------
------------------------------------------------------------------tt-------------------------------------------------------------------------------------------------------------------
----------------------------------------------------------------#####------1------------------------------------------------------------------------------------------------------1----
----------------C--------!----#------------------!---#------tt-######-------------SS----#-----S@S!S---------------C-----SS------#--#--------C------tt----!-------tt--------tt----------
------------------------------##---------------------##-----tt#######-------------------##-------------------------------------##--##--------------tt------------tt--------tt----------
---XTT------------------------###--tt----------------###----tt#######-------------------###-----------------------------------###--###-------------tt------------tt--------tt----------
-M--tt------------------------####-tt----g-g-tt--k---####-----------------g-g-ttg-g-----####---g-----#######-----g-g--g-g----####--####----g-g-----tt----k---####----------------------
XXXXXXXXXXXXXXX---XXXXXXXXXXX-XXXXXXXXXXXXXXXXXXXXXXXXXXXXXXXXXXXXXXX--XXXXXXXXXXXXXXXXXXXXXXXXXXXXXXXXXXXXXXXXXXXXXXXXXXXXXXXXXXXXXXXXXXXXXXXXXXXXXXXXXXXXXXXXXXXXXXXXXXXXXX----------
XXXXXXXXXXXXXXX---XXXXXXXXXXX-XXXXXXXXXXXXXXXXXXXXXXXXXXXXXXXXXXXXXXX--XXXXXXXXXXXXXXXXXXXXXXXXXXXXXXXXXXXXXXXXXXXXXXXXXXXXXXXXXXXXXXXXXXXXXXXXXXXXXXXXXXXXXXXXXXXXXXXXXXXXXX----------
