-------------------------------------------------------------------------------------------------------------------------------------------------------------------------
-------------------------------------------------------------------------------------------------------------------------------------------------------------------------
--------------------------SSSSS----------------------------------------------------------------------------------------------------C-------------------------------------
------------------------------------------------------------------------------------------------------------------------------------------1------------------------------
------------------------------------------------------------------------------------------------------------------------XXXXXXXXXX---------------------------------------
------------------------------------------------------------------------------------------------------------------------XXXXXXXXXX---------------------------------------
-----------------------------------------------------------------------------------------------------------------------------#######-------------------------------------
-------------------------#####-------------------------------------------------------------------------------------------------------------#####-------------------------
------------------------######------------------------------------------------------------------------------------------------------------######-------------------------
-----------------------#######-----------------------------------------------------------------------------------------------------------#######-------------------------
-----SS------#--#-----S#######----S@S!S----tt-------------S@S!S-------##--------S@S!S----------------------##--#------------SS------#--#-#######-------tt----SS---!--!---
------------##--##-------------------------tt------------------------###----------------------------------###--##------------------##--##--------------tt----------------
-----------###--###------------------------tt------XTT--------------####-XTT-----------------------------####--###-----tt---------###--###-------------tt----------------
-M-g-g----####--####---------------g-----#######----tt-----g-------#####--tt-----g-----#######-----gg---#####--####----tt-g-g----####--####----g-g-----tt--g-g-----------
XXXXXXXXXXXXXXXXXXXXXXXXXXX---XXXXXXXXXXXXXXXXXXXXXXXXXXXXXXXXXXXXXXXXXX-XXXXXXXXXXXXXXXXXXXXXXXXXXXXXXXXXXXX--XXXXXXXXXXXXXXXXXXXXXXXXXXXXXXXXXXXXXXXXXXXXXXXXXXXXXXXXXX
XXXXXXXXXXXXXXXXXXXXXXXXXXX---XXXXXXXXXXXXXXXXXXXXXXXXXXXXXXXXXXXXXXXXXX-XXXXXXXXXXXXXXXXXXXXXXXXXXXXXXXXXXXX--XXXXXXXXXXXXXXXXXXXXXXXXXXXXXXXXXXXXXXXXXXXXXXXXXXXXXXXXXX
