---------------------------------------------------------------------------------------------------------------------------------------------------------------------------------------------------------
---------------------------------------------------------------------------------------------------------------------------------------------------------------------------------------------------------
---------------------------------------------------------------------------------------------------------------------------------------------------------------------------------------------------------
---------------------------------------------------------------------------------------------------------------------------------------------------------------------------------------------------------
-------------------------------------------------------------------------------------------------------------------------------------SSSSS---SSS!----SSS!------------------------------------------------
---------------------------------------------------------------------------------------------------------------------------------------------------------------------------------------------------------
---------------------------------------------------------------------------------------------------------------------------------------------------------------------------------------------------------
---------------------------------------------------------------------------------------------------------------------------------------------------------------------------------------------------------
------------------------------------------------------------------------------------------------------------------------------------------------C-------C----------------SS!S---------!--------------SS!S
---------------------------------------------------------------------------------------------------------------------------------------#####----------------------tt-------------------------------------
-----SS!S----------!-----SS------#--#-----SU---------------------##---SS----#-----------------##--#-----------------tt----------------######----------------------tt-----------tt-#----------------------
--------------------------------##--##-----------------tt-------###---------##---------------###--##----------------tt----tt---------#######-----g-g--------------tt-g---------tt##----------g-g-tt------
---------XTT-------------------###--###----------------tt------####---------###---XTT-------####--###-----tt--------tt----tt-----tt-########---XXXXXXXX---XXXXXXXXXXXXXXXXXXXXXXXXXXXXXXXXXXXXXXXXXXXXXXX
-M--------tt-----------g-g----####--####--------gg-----tt-g---#####-g-g-----####---tt------#####--####----tt----g-g-tt----tt-g---tt##----------XXXXXXXX---XXXXXXXXXXXXXXXXXXXXXXXXXXXXXXXXXXXXXXXXXXXXXXX
XXXXXXXXXXXXXXXXXXXXXXXXXXXXXXXXXXXXXXXXXXXXXXXXXXXXXXXXXXXXXXXXXXX-XXXXXXXXXXXXXXXXXXXXXXXXXXXX--XXXXXXXXXXXXXXXXXXXXXXXXXXXXXXXXXXX--------------------------------------------------------------------
XXXXXXXXXXXXXXXXXXXXXXXXXXXXXXXXXXXXXXXXXXXXXXXXXXXXXXXXXXXXXXXXXXX-XXXXXXXXXXXXXXXXXXXXXXXXXXXX--XXXXXXXXXXXXXXXXXXXXXXXXXXXXXXXXXXX------g-g-----------------------------------------------------------
