-------------------------------------------------------------------------------------------------------------------------------------------------------------------------------------------
-------------------------------------------------------------------------------------------------------------------------------------------------------------------------------------------
-------------------------------------------------------------------------------------------------------------------------------------------------------------------------------------------
-------------------------------------------------------------------------------------------------------------------------------------------------------------------------------------------
-------------------------------------------------------------------------------------------------------------------------------------------------------------------------------------------
-------------------------------------------------------------------------------------------------------------------------------------------------------------------------------------------
-------------------------------------------------------------------------------------------------------------------------------------------------------------------------------------------
--------------------------------------1-----------------------------------------------------------------------------------------------g----------------------------------------------------
----------------SSS-----------------------------------------------SSS!--------------------------------------------------------------SSSSSSSS---SSS!----------------------------------------
-------------------------------------------------------------------------------------------------------------------------------------------------------------------------------------------
------!--------------------tt--------------------!-----#--#------------------tt--SU---#-------------!-----!---#-------------t------g----------------------tt----!-----#--#-----------------
---------------------------tt------tt-----------------##--##-----------------tt-------##----------------------##------------t-----------------------------tt---------##--##----------------
---------------------------tt------tt----------------###--###--------C-------tt-------###-----tt--------------###-----------t----S@S--------------C-------tt--------###--###---------------
-M-----------g-g-tt--gg----tt------tt-g---g-g----k--####--####--#######------tt-------####----tt----------k---####----------tt---------------#######------tt----k--####--####--------------
XXXXXXXXXXXXXXXXXXXXXXXXXXXXXXXXXXXXXXXXXXXXXXXXXXXXXXXXXXXXXXXXXXXXXXXXXXXXXXXXXXXXX-XXXXXXXXXXXXXXXXXXXXXXXXXXXXXXXXXXXXXXXXXXXXXXXXXXXX---XXXXXXXXXXXXXXXXXXXXXXXXXXXXXXXXXXXXXXXXXXXX--
XXXXXXXXXXXXXXXXXXXXXXXXXXXXXXXXXXXXXXXXXXXXXXXXXXXXXXXXXXXXXXXXXXXXXXXXXXXXXXXXXXXXX-XXXXXXXXXXXXXXXXXXXXXXXXXXXXXXXXXXXXXXXXXXXXXXXXXXXX---XXXXXXXXXXXXXXXXXXXXXXXXXXXXXXXXXXXXXXXXXXXX--
