-------------------------------------------------------------------------------------------------------------------------------------------------------------------------------------------------
-------------------------------------------------------------------------------------------------------------------------------------------------------------------------------------------------
-------------------------------------------------------------------------------------------------------------------------------------------------------------------------------------------------
-------------------------------------------------------------------------------------------------------------------------------------------------------------------------------------------------
-----------------------------------------------------------tt------------------------------------------------------------------------------------------------------------------------------------
-----------------------------------------------------------tt------------------------------------------------------------------------------------------------------------------------------------
-----------------------------------------------------------tt------------------------------------------------------------------------------------------------------------------------------------
---------------------------------------------------------#####-----------------------------------------------------------------------------------------------------------------------------------
--------------------------------------------------------######-----------------------------------------------------------------------------------------------##----------------------------------
-------------------------------------------------------#######----------------------------------------------------------------------------------------------###----------------------------------
---S@S!S----!-----#--#-------!---#-------SS------#--#--#######-------!----#----------------##----SS!SS@S!S------------------!-----#--#------------------tt--###-----!---#------------------------
-----------------##--##----------##-------------##--##--------------------##--------------###------------------------tt----------##--##-----------------tt--------------##-----------------------
----------------###--###---------###-----------###--###-------------------###-----tt-----####------------------------tt---------###--###-----tt-#-------tt--------------###---XTT----------------
-M--g-------k--####--####----k---####--g-g----####--####------------------####----tt-#######----------g-------gg-----tt-g---k--####--####----tt##---g-g-tt----------k---####---tt----------------
XXXXXXXXXXXXXXXXXXXXXXXXXXXXXXXXXXXXXXXXXXXXXXXXXXXXXXXXXXX---XXXXXXXXXXX-XXXXXXXXXXXXXXXXXXXXXXXXXXXXXXXXXXXXXXXXXXXXXXXXXXXXXXXXXXXXXXXXXXXXXXXXXXXXXXXXX---XXXXXXXXXXXXXXXXXXXXXXXXXXXXXXXXX--
XXXXXXXXXXXXXXXXXXXXXXXXXXXXXXXXXXXXXXXXXXXXXXXXXXXXXXXXXXX---XXXXXXXXXXX-XXXXXXXXXXXXXXXXXXXXXXXXXXXXXXXXXXXXXXXXXXXXXXXXXXXXXXXXXXXXXXXXXXXXXXXXXXXXXXXXX---XXXXXXXXXXXXXXXXXXXXXXXXXXXXXXXXX--
