----------------------------------------------------------------------------------------------------------------------------------------------------------------------------------------------------------
----------------------------------------------------------------------------------------------------------------------------------------------------------------------------------------------------------
----------------------------------------------------------------------------------------------------------------------------------------------------------------------------------------------------------
----------------------------------------------------------------------------------------------------------------------------------------------------------------------------------------------------------
----------------------------------------------------------------------------------------------------------------------------------------------------------------------------------------------------------
----------------------------------------------------------------------------------------------------------------------------------------------------------------------------------------------------------
----------------------------------------------------------SSS!--------------------------------------------------------------------------------------------------------------------------------------------
----------------------------------------------------------------------------------------------------------------------------------------------------------------------------------------------------------
----------------------------------------------------------------------------------------------------------------------------------------------------------------------------------------------------------
-------------------------------------------1--------------------------------------------------------------------------------------------------------------------------------------------------------------
------------------------------SU--S@S!S---------------t------C------tt---------------------##---------SS------#--#----------tt---SU----SS------#--#-------!---#----------tt----------!---#----------------
------------tt----------------------------------------tt------------tt------tt------------###----------------##--##---------tt----------------##--##----------##---------tt--------------##-------------tt
------------tt---XTT------tt-#------------------------tt------------tt------tt-----------####---tt-#--------###--###--------tt---------------###--###---------###--------tt--------------###------------tt
-M---gg-----tt-g--tt------tt##-----g-----#######------tt----g-g-----tt------tt-g---gg---#####---tt##g-g----####--####--#######-------g-g----####--####----k---####--#######----------k---####----gg-----tt
XXXXXXXXXXXXXXXXXXXXXXXXXXXXXXXXXXXXXXXXXXXXXXXXXXXXXXXXXXXXXXXXXXXXXXXXXXXXXXXXXXXXXXXXXXXXX-XXXXXXXXXXXXXXXXXXXXXXXXXXXXXXXXXXXXXXXXXXXXXXXXXXXXXXXXXXXXXXXXXXXXXXXXXXXXXXXXXXXXXXXXXXXXXXXXXXXXXXXXXXXX
XXXXXXXXXXXXXXXXXXXXXXXXXXXXXXXXXXXXXXXXXXXXXXXXXXXXXXXXXXXXXXXXXXXXXXXXXXXXXXXXXXXXXXXXXXXXX-XXXXXXXXXXXXXXXXXXXXXXXXXXXXXXXXXXXXXXXXXXXXXXXXXXXXXXXXXXXXXXXXXXXXXXXXXXXXXXXXXXXXXXXXXXXXXXXXXXXXXXXXXXXX
