--------------------------------------------------------------------------------------------------------------------------------------------------------------------------------------------------
--------------------------------------------------------------------------------------------------------------------------------------------------------------------------------------------------
--------------------------------------------------------------------------------------------------------------------------------------------------------------------------------------------------
--------------------------------------------------------------------------------------------------------------------------------------------------------------------------------------------------
--------------------------------------------------------------------------------------------------------------------------------------------------------------------------------------------------
--------------------------------------------------------------------------------------------------------------------------------------------------------------------------------------------------
--------------------------SSS!--------------------------------------------------------------------------------------------------------------------------------------------------------------------
--------------------------------------------------------------------------------------------------------------------------------------------------------------------------------------------------
----------SSS!------------------------------------------------------------------------------------------------------------------------------------------------------------------------------------
------------------------------------------------------------------------1-------------------------------------------------------------------------------------------------------------------------
-----------------------------C-------------##---!---#------------------------SU---#---------SS----#-------!---#-------SS----#--------!---S@S!S----SS------#--#-----------------SU----------#------
------------------------------------------###-------##----------------------------##--------------##----------##------------##---------------------------##--##----------------------------##-----
-------------C----XTT--------------------####-------###----------tt-#-------------###--tt---------###---------###-----------###-------------------------###--###--------XTT--------XTT-----###----
-M---gg-#######----tt--------------gg---#####---k---####----gg---tt#---g-g-tt-----####-tt-g-g-----####----k---####--g-g-----####----------g-----g-g----####--####----gg--tt---------tt-----####---
XXXXXXXXXXXXXXXXXXXXXXXXXX---XXXXXXXXXXXXXXXX-XXXXXXXXXXXXXXXXXXXXXXXXXXXXXXXXXXX-XXXXXXXXXXXXXXXXXXXXXXXXXXXXXXXXXXXXXXXXXXXXXXXXXXXXXXXXXXXXXXXXXXXXXXXXXXXXXXXXXXXXXXXXXXXXXXXXXXXXXXXX-XXXXXXX
XXXXXXXXXXXXXXXXXXXXXXXXXX---XXXXXXXXXXXXXXXX-XXXXXXXXXXXXXXXXXXXXXXXXXXXXXXXXXXX-XXXXXXXXXXXXXXXXXXXXXXXXXXXXXXXXXXXXXXXXXXXXXXXXXXXXXXXXXXXXXXXXXXXXXXXXXXXXXXXXXXXXXXXXXXXXXXXXXXXXXXXX-XXXXXXX
