---------------------------------------------------------------------------------------------------------------------------------------------------------------------------------------------
---------------------------------------------------------------------------------------------------------------------------------------------------------------------------------------------
---------------------------------------------------------------------------------------------------------------------------------------------------------------------------------------------
---------------------------------------------------------------------------------------------------------------------------------------------------------------------------------------------
---------------------------------------------------------------------------------------------------------------------------------------------------------------------------------------------
---------------------------------------------------------------------------------------------------------------------------------------------------------------------------------------------
--------------------------------------------------------------SSSSS----------------------------------------------------------------------------------------------------------SSS!------------
-----------------------------------------------------------------------------------------------------------------------------1---------------------------------------------------------------
-----------------------------------------------------------------------------------------------------------tt--------------------------------------------------------------------------------
-------------------1---------------------------------------#####-------------------------------------------tt--------------------------------------------------------------------------------
---S@S!S----------------------!---SU----!-----#--#--------######----------!---#--------!------------tt-----tt------------------------------##---SS------#--#-------SS----#------C--------tt--
---------------------------------------------##--##------#######--------------##--------------------tt------------------------------------###----------##--##------------##--------------tt--
----------XTT-------------------------------###--###-----#######--------------###------------tt-#---tt--------------XTT------------------####---------###--###-----------###-------------tt--
-M--g------tt----#######----------------k--####--####-----g-g-tt----------k---####-----------tt##---tt---------g-g---tt----------g-g----#####-g-g----####--####--g-g-----####----g-g-----tt--
XXXXXXXXXXXXXXXXXXXXXXXXXXXXXXXXXXXXXXXXXXXXXXXXXXXXXXXXXXXXXXXXX---XXXXXXXXXXXXXXXXXXXXXXXXXXXXXXXXXXXXXXXXXXXXXXXXXXXXXXXXXXXXXXXXXXXXXXXXX-XXXXXXXXXXXXXXXXXXXXXXXXXXXXXXXXXXXXXXXXXXXXXXX
XXXXXXXXXXXXXXXXXXXXXXXXXXXXXXXXXXXXXXXXXXXXXXXXXXXXXXXXXXXXXXXXX---XXXXXXXXXXXXXXXXXXXXXXXXXXXXXXXXXXXXXXXXXXXXXXXXXXXXXXXXXXXXXXXXXXXXXXXXX-XXXXXXXXXXXXXXXXXXXXXXXXXXXXXXXXXXXXXXXXXXXXXXX
