-------------------------------------------------------------------------------------------------------------------------------------------------------------------------------------------------
-------------------------------------------------------------------------------------------------------------------------------------------------------------------------------------------------
-----------------------------SSSSS---------------------------------------------------------------------------------------------------------------------------------------------------------------
-------------------------------------------------------------------------------------------------------------------------------------------------------------------------------------------------
-------------------------------------------------------------------------------------------------------------------------------------------------------------------------------------------------
-------------------------------------------------------------------------------------------------------------------------------------------------------------------------------------------------
-------------------------------------------------------------------------SSS!--------------------------------------------------------------------------------------------------------------------
----------------------------#####----------------------------------------------------------------------------------------------------------------------------------------------------------------
---------------------------######----------------------------------------------------------------------------------------------------------------------------------------------------------------
--------------------------#######-------------------------------------------------------------------------------------------------------------------------------------------------#####---####---
-----------------##-------#######---------------------!---------------------C--------------tt----#-------S@S!S-------##----!------tt----!---#-------------------!----#-----------######---####---
-------tt-------###-----tt--------------------tt--------------tt---------------------------tt----##-----------------###-----------tt--------##-----------------------##---------#######---####---
-------tt------####-----tt--------------------tt--------------tt---------------------------tt----###--tt-----------####-----------tt--------###----------tt-#--------###-----tt-#######---####---
-M-----tt-g---#####-----tt-g------------------tt-g------------tt-g------------------gg----g-g-tt-####-tt--g-------#####-----------tt----k---####----gg---tt##--------####----tt------------------
XXXXXXXXXXXXXXXXXXX-XXXXXXXXXX---XXXXXXXXXXXXXXXXXXXXXXXXXXXXXXXXXXXXXXXXXX---XXXXXXXXXXXXXXXXXX-XXXXXXXXXXXXXXXXXXXXXX-XXXXXXXXXXXXXXXXXXXXXXXXXXXXXXXXXXXXXXXXXXXX-XXXXXXXXXXXXXXXXXXXXXXXXX---
XXXXXXXXXXXXXXXXXXX-XXXXXXXXXX---XXXXXXXXXXXXXXXXXXXXXXXXXXXXXXXXXXXXXXXXXX---XXXXXXXXXXXXXXXXXX-XXXXXXXXXXXXXXXXXXXXXX-XXXXXXXXXXXXXXXXXXXXXXXXXXXXXXXXXXXXXXXXXXXX-XXXXXXXXXXXXXXXXXXXXXXXXX---
