-----------------------------------------------------------------------------------------------------------------------------------------------------------------------------------
-----------------------------------------------------------------------------------------------------------------------------------------------------------------------------------
-----------------------------------------------------------------------------------------------------------------------------------------------------------------------------------
-----------------------------------------------------------------------------------------------------------------------------------------------------------------------------------
-----------------------------------------------------------------------------------------------------------------------------------------------------------------------------------
-----------------------------------------------------------------------------------------------------------------------------------------------------------------------------------
--------------------------------------------tt-------------------------------------------------------------------------------------------------------------------------------------
--------------------------------------------tt-------------------------------------------------g-----------------------------------------------------------------------------------
-----------------------------------##-------tt----------------SSSSS---SSS!-------------------SSSSSSSS-----------------------------------SSSSS--------------------------------------
----------------------------------###--------#####------1----------------------------1---------------------------------------------------------------------------------------------
---S@S!S-------##---SS----#------####-------######----------------------------tt------------g--------------##---SS----#--------------------------------SS!S----------tt-----tt-----
--------------###---------##---------------#######----------------------------tt--------------------------###---------##--------tt-----------------------------------tt-----tt-----
-------------####---------###--------------#######-----------------------C----tt----------S@S------------####---------###-------tt------------XTT----------XTT-------tt-----tt-----
-M--g-------#####-g-g-----####----------------------g-g-tt-------------------------#######------g-g-tt--#####-g-g-----####------tt-g----g-g-tt-tt-----------tt------gg-------------
XXXXXXXXXXXXXXXXX-XXXXXXXXXXXXXXX---XXXXXXXXXXXXXXXXXXXXXXXXXXXXXXXX--XXXXXXXXXX---XXXXXXXXXXXXXXXXXXXXXXXXXX-XXXXXXXXXXXXXXXXXXXXXXXXXXXXXXXXXXXXXXXXXXXXXXXXXXXXXXXXXXXXXXXXXXX--
XXXXXXXXXXXXXXXXX-XXXXXXXXXXXXXXX---XXXXXXXXXXXXXXXXXXXXXXXXXXXXXXXX--XXXXXXXXXX---XXXXXXXXXXXXXXXXXXXXXXXXXX-XXXXXXXXXXXXXXXXXXXXXXXXXXXXXXXXXXXXXXXXXXXXXXXXXXXXXXXXXXXXXXXXXXX--
