-------------------------------SU----------------------------------------------------------------
-------------------------------------------------------------------------------------------------
T------------------C------C----------------------------------------------------------------------
t-------g-g-tt#######---####---------------g-g-tt-----#---------1--------------------------------
XXXXXXXXXXXXXXXXXXXXXXXXXXXXXXXXXXXXXXXXXXXXXXXXXXXXXXXXXX---------------------------------------
XXXXXXXXXXXXXXXXXXXXXXXXXXXXXXXXXXXXXXXXXXXXXXXXXXXXXXXXXX---------------------------------------
---------------------------------------------------#######---------------------------------------
-----------------------------------------------------------------#####---------------------------
-------------------------tt-------------------------------------######----------------------SSS!-
-------------------------tt------------------------------------#######---------------------------
--------##---------------tt---------SS------#--#-------SS----#-#######------SS!S-------##--------
-------###---------------------------------##--##------------##-----------------------###--------
------####---tt-#-------------------------###--###-----------###---------------------####------C-
-M---#####---tt##-----------------g-g----####--####--g-g-----####----g-g----------gg-------------
XXXXXXXXXX-XXXXXXXXXXXXXXXX---XXXXXXXXXXXXXXXXXXXXXXXXXXXXXXXXXXXXXXXXXXXXXXXXXXXXXXXXXXXXXXXXX--
XXXXXXXXXX-XXXXXXXXXXXXXXXX---XXXXXXXXXXXXXXXXXXXXXXXXXXXXXXXXXXXXXXXXXXXXXXXXXXXXXXXXXXXXXXXXX--
