----------------------------------------------------------------------------------------------------------------------------------------------------------------------------------------------------
----------------------------------------------------------------------------------------------------------------------------------------------------------------------------------------------------
----------------------------------------------------------------------------------------------------------------------------------------------------------------------------------------------------
----------------------------------------------------------------------------------------------------------------------------------------------------------------------------------------------------
----------------------------------------------------------------------------------------------------------------------------------------------------------------------------------------------------
----------------------------------------------------------------------------------------------------------------------------------------------------------------------------------------------------
----------------------------------------------------------------------------------------------------------------------------------------------------------------------------------------------------
---------------------------------------------------------------------------------1------------------------------------1-----------------------------------------------------------------------------
----------------------------------------------------------------------------------------------------------S----tt-----------------------------SSSSS---------------------------------------tt--------
---------------------------------------------------------------------------------------------------------------tt-------------------------------------------------------------------------tt--------
------------SS----#-------SS----#--------tt----SS----tt-----------##-S@S!S-------------------!--------##-------tt----------------------!-----------------##---SS------#--#----------------tt----SU--
------------------##------------##-------tt----------tt----------###-----------tt--------------------###------------------------------------------------###----------##--##-------------------------
------------------###-----------###------tt----------tt---------####-----------tt-------------------####-----------------------------------------------####---------###--###------------------------
-M---g-g--g-g-----####--g-g-----####-----tt--------#######-----#####--g--------tt----g-g-----------#####-#######------------------------------g-g-tt--#####-g-g----####--####-----g-g-tt------------
XXXXXXXXXXXXXXXXXXXXXXXXXXXXXXXXXXXXXXXXXXXXXXXXXXXXXXXXXXXXXXXXXXXX-XXXXXXXXXXXXXXXXXXXXXXXXXXXXXXXXXXX-XXXXXXXXXXXXXXX---XXXXXXXXXXXXXXXXXXXXXXXXXXXXXXXX-XXXXXXXXXXXXXXXXXXXXXXXXXXXXX---XXXXXXXX
XXXXXXXXXXXXXXXXXXXXXXXXXXXXXXXXXXXXXXXXXXXXXXXXXXXXXXXXXXXXXXXXXXXX-XXXXXXXXXXXXXXXXXXXXXXXXXXXXXXXXXXX-XXXXXXXXXXXXXXX---XXXXXXXXXXXXXXXXXXXXXXXXXXXXXXXX-XXXXXXXXXXXXXXXXXXXXXXXXXXXXX---XXXXXXXX
