-----------------------------------SSSSS--SSSSS---SSS!-----SSSSS---SSS!-----------------------
----------------------------------------------------------------------------------------------
-----------------------------C----------------------------------------------------------------
--------g-g-tt--------------------------------------------------------------------------------
-----XXXXXXXXXXXXXXXXXXX-----------------------------C----------------C-----------------------
-----XXXXXXXXXXXXXXXXXXX--------------------------------------------#####------1--------------
------------------XXXXXXXXXXXXXXXXX--X--XXXXXXXX----XXXXXXXXXX-----######---------------------
------------------XXXXXXXXXXXXXXXXX--X--XXXXXXXX----XXXXXXXXXX----#######---------------------
------------------------------------------------------------------#######---------------------
--------------------------------------------------------------------------------####---1------
--------##---SS----#------------S@S!S---------SS!S-----SU-----tt--S@S!S--------#####----------
-------###---------##-----------------------------------------tt-------------t######----------
------####---------###---XTT----------------------------------tt-------------t######----------
-M---#####-g-g-----####---tt-----g------------------gg--------tt---g---------tt-g-------------
XXXXXXXXXX-XXXXXXXXXXXXXXXXXXXXXXXXXXXXXXXXXXXXXXXXXXXXXXXXXXXXXXXXXXXXXXXXXXXXXXXXXXXXXXXXX--
XXXXXXXXXX-XXXXXXXXXXXXXXXXXXXXXXXXXXXXXXXXXXXXXXXXXXXXXXXXXXXXXXXXXXXXXXXXXXXXXXXXXXXXXXXXX--
