-----------------------------------------------------------------------------------------------------------------------------------------------------------------------------------------
-----------------------------------------------------------------------------------------------------------------------------------------------------------------------------------------
-----------------------------------------------------------------------------------------------------------------------------------------------------------------------------------------
-----------------------------------------------------------------------------------------------------------------------------------------------------------------------------------------
-----------------------------------------------------------------------------------------------------------------------------------------------------------------------------------------
-----------------------------------------------------------------------------------------------------------------------------------------------------------------------------------------
SSSSS-----------------------------------------------------------------------------------------------------------SSS!---------------------------------------------------------------------
-------------------------------------------------------------------g---------------------------------------------------------------------------------------------------------------------
-----------------------------------------------------------------SSSSSSSS---SSS!---------------------------------------------------------------------------------------------------------
-----------------------------------------------------------------------------------------------------------------------------------------------------------------------------------------
----------------------!--------SU--S@S!S----SS----#-------------g-------------------------------!-----#--#---------C-----------#------------!---#---------------------------SS!S--!-----#
--------------tt----------------------------------##--------#----------------------tt----------------##--##--------------------##---------------##--------tt---------------------------##
--------------tt----------------------------------###------##-S@S------------------tt-----tt-#------###--###-----------XTT-----###-----tt-------###-------tt----------tt-#------------###
-M---g-g------tt-g----------gg------g-----g-g-----####----#####----------g-g-tt----tt-g---tt##--k--####--####-----------tt-----####----tt---k---####------tt-g---gg---tt##--------k--####
XXXXXXXXXXXXXXXXXXXXXXXXXXXXXXXXXXXXXXXXXXXXXXXXXXXXXXXXXXXXXXX-XXXXXXXXXXXXXXXXXXXXXXXXXXXXXXXXXXXXXXXXXXXXXXXX---XXXXXXXXXXX-XXXXXXXXXXXXXXXXXXXXXXXXXXXXXXXXXXXXXXXXXXXXXXXXXXXXXXXXXX
XXXXXXXXXXXXXXXXXXXXXXXXXXXXXXXXXXXXXXXXXXXXXXXXXXXXXXXXXXXXXXX-XXXXXXXXXXXXXXXXXXXXXXXXXXXXXXXXXXXXXXXXXXXXXXXX---XXXXXXXXXXX-XXXXXXXXXXXXXXXXXXXXXXXXXXXXXXXXXXXXXXXXXXXXXXXXXXXXXXXXXX
