------------------------------------------------------------------------------------------------------------------------------
-------------------------------------------------------------------------#####------1-----------------------------------------
------------------------------------------------------------------------######------------------------------------------------
-----------------------------------------------------------------------#######------------------------------------------------
-----------------------------------------------------------------------#######------------------------------------------------
------------------------------------------------------------------------g-g-tt-------#####------1-----------------------------
-------------------------------------------------------------------##XXXXXXXXX------######------------------------------------
-----------------------g------------------------------------------###XXXXXXXXX-----#######------------------------------------
----------SSSSS------SSSSSSSS---SSS!-----------------------------####--------------#######---------------------SSSSS----------
-#####-------------------------------#####----------------------#####----------------------------#####------------------------
######--------------g---------------######----------------tt---######-----SS!S-------tt---------######------------------------
######-----------------------------#######----------------tt--#######----------------tt--------#######------------------------
######------------S@S--------------#######-----tt---------tt--#######----------------tt--------#######------------------------
-M--------#######------------------------------tt-------------#######--------------#######------g-g-tt--gg-#######--------#---
XXXXXXXXXXXXXXXXXXXXXXXXXXXXXX--XXXXXXXXXX----XXXXXXXXXXXXXX--XXXXXXXXXXXXXXXXXXXXXXXXXXXXXXXXXXXXXXXXXXXXXXXXXXXXXXXXXXXXXXXX
XXXXXXXXXXXXXXXXXXXXXXXXXXXXXX--XXXXXXXXXX----XXXXXXXXXXXXXX--XXXXXXXXXXXXXXXXXXXXXXXXXXXXXXXXXXXXXXXXXXXXXXXXXXXXXXXXXXXXXXXX
