------------------------------------------------------------------------------------------------------------------------------------------------------
------------------------------------------------------------------------------------------------------------------------------------------------------
------------------------------------------------------------------------------------------------------------------------------------------------------
------------------------------------------------------------------------------------------------------------------------------------------------------
-------------------------------------------------------------SSS!-----------------------------SSS!----------------------------------------------------
------------------------------------------------------------------------------------------------------------------------------------------------------
---------------------------------##-------------------------------------------------------------------------------------------------------------------
--------------------------------###-------------------------------------------------------------------------------------------------------------------
-------S---SSS!--SSSSS---SSS!--####-----------------------------C--------------------------------C----------------------------------------------------
------------------------------#####------1-----------1------#####------------------------------#----------1-------------------------------------------
-----------------------------######-----------SU-----------######----SS!S--------tt---SS!S----##------------------------------------------------------
----------------------------#######-----------------------#######----------------tt----------###----------------------tt------------------------------
--------------C-------------#######-----------------------#######----------------tt----------###----------------------tt-----tt-#------------tt-#-----
-M-#######------------------------------g-g-tt------gg--------------------------------------------------#######-------tt-g---tt#########-----tt##-----
XXXXXXXXXXXXXXXXXXXXXXX--XXXXXXXXXX--XXXXXXXXXXXXXXXXXXXXXXXXXXXX--XXXXXXXXXXXXXXXX-XXXXXXXXXXXXXXXXXXXXXXXXXXXXXXXXXXXXXXXXXXXXXXXXXXXXXXXXXXXXXXXXXX
XXXXXXXXXXXXXXXXXXXXXXX--XXXXXXXXXX--XXXXXXXXXXXXXXXXXXXXXXXXXXXX--XXXXXXXXXXXXXXXX-XXXXXXXXXXXXXXXXXXXXXXXXXXXXXXXXXXXXXXXXXXXXXXXXXXXXXXXXXXXXXXXXXX
