---------------------------------------------------------------------------
---------------------------------------------------------------------------
----------XTT--------------------------------------------------------------
-----------tt--------------------------#####------1------------------------
-----XXXXXXXXXXXXXXXXXXXXXX------tt---######-------------------------------
-----XXXXXXXXXXXXXXXXXXXXXX------tt--#######-------------------------------
---------------------#######-----tt--#######-------------------------------
---------------------------------------------------#####-------------------
-------------------------XXXXXXXXXX---------------######-------------------
-------------------------XXXXXXXXXX--------------#######-------------------
-----SS!S---tt--S@S!S-------##---------------S@S!#######-------------------
------------tt-------------###---------------------------------------------
------------tt------------####--------------------------------tt-#---------
-M----------tt---g-------#####----g-g-tt--gg--g---------------tt##-----#---
XXXXXXXXXXXXXXXXXXXXXXXXXXXXXX-XXXXXXXXXXXXXXXXXXXXXX---XXXXXXXXXXXXXXXXXXX
XXXXXXXXXXXXXXXXXXXXXXXXXXXXXX-XXXXXXXXXXXXXXXXXXXXXX---XXXXXXXXXXXXXXXXXXX
