----------------------------------------------------------------------------------------------------------------------------------------------------------------------------
----------------------------------------------------------------------------------------------------------------------------------------------------------------------------
----------------------------------------------------------------------------------------------------------------------------------------------------------------------------
----------------------------------------------------------------------------------------------------------------------------------------------------------------------------
--------------------------------------------------------------------------------------------------------SSSSS---SSS!--------------------------------------------------------
----------------------------------------------------------------------------------------------------------------------------------------------------------------------------
------------------------------------------------------------------------------------tt--------------------------------------------------------------------------------------
--------------------------------------------------g---------------------------------tt--------------------------------------------------------------------------------------
------------------------------------------------SSSSSSSS---SSS!---------------------tt-----------------------------C--------------------------------------------------------
-------------------------------------------------------------------#####-------------#####------1------#####-----#####------------------------------------------------------
----------#------------##------S@S!S-----------g------------------######------------######------------######----######--SS----#----------------SS!S--!-----#--#----------##-
----------##----------###----------------------------------------#######-----------#######-----------#######---#######--------##--------tt----------------##--##--------###-
-----tt-#-###--tt----####---------------tt-#-S@S--------------C--#######-XTT-------#######-----------#######---#######--------###-------tt---------------###--###------####-
-M---tt##-####-tt---#####-------g-------tt##------------g-g-tt------------tt------------------------------------g-g-ttg-g-----####------tt-g---------k--####--####----#####-
XXXXXXXXX-XXXXXXXXXXXXXXX-XXXXXXXXXXXXXXXXXXXXXXXXXXXXXXXXXXXXXXXXXXXXXX-XXXXXXXXXXXXXXXXX--------XXXXXXXXXX-XXXXXXXXXXXXXXXXXXXXXXXXXXXXXXXXXXXXXXXXXXXXXXXXXXXXXXXXXXXXXX-
XXXXXXXXX-XXXXXXXXXXXXXXX-XXXXXXXXXXXXXXXXXXXXXXXXXXXXXXXXXXXXXXXXXXXXXX-XXXXXXXXXXXXXXXXX--------XXXXXXXXXX-XXXXXXXXXXXXXXXXXXXXXXXXXXXXXXXXXXXXXXXXXXXXXXXXXXXXXXXXXXXXXX-
