--------------------------------------------------------------------------------------------------------------------------------------------------------------
----------------------------------------------------------g---------------------------------------------------------------------------------------------------
---------------------------------------------SSSSS------SSSSSSSS---SSS------------------SSS!--------------SSS!------------------------------------------------
--------------------------------------------------------------------------------------------------------------------------------------------------------------
---------------------------------tt--------------------g---------------------------------------------##-------------SS----#-------------------------------!---
---------------------------------tt----------------------------------------------tt-----------------###-------------------##----------------------------------
---------------------------------tt------------------S@S--------------XTT--------tt--------C-------####------C------------###----------tt-#-------------------
----------------------------------#####--------#####------------g-g-tt-tt--------tt-g-#######-----#####-#######---g-g-----####---------tt##-------g-g---------
---------------------------------######-------######---XXXXXXXXXXXXXXXXXXXXXXXXXXXXXXXXXXXXXXXXXXXXXXXX-XXXXXXXXXXXXXXXXXXXXXXXXXXXXXXXXXXXXXXXXXXXXXXXXXXXXXX
--------------------------------#######------#######---XXXXXXXXXXXXXXXXXXXXXXXXXXXXXXXXXXXXXXXXXXXXXXXX-XXXXXXXXXXXXXXXXXXXXXXXXXXXXXXXXXXXXXXXXXXXXXXXXXXXXXX
---S@S!S----SS!S-----------#----#######------#######----------------------------------------------------------------------------------------------------------
---------------------------##---------------------------------------------------------------------------------------------------------------------------------
---------------------------###--tt-----------tt-#-------------------------------------------------------------------------------------------------------------
-M--g-------------gg-------####-tt-----------tt##--g-g-------#------------------------------------------------------------------------------------------------
XXXXXXXXXXXXXXXXXXXXXXXXXX-XXXXXXXXX---XXXXXXXXXXXXXXXXXXXXXXXXXX---------------------------------------------------------------------------------------------
XXXXXXXXXXXXXXXXXXXXXXXXXX-XXXXXXXXX---XXXXXXXXXXXXXXXXXXXXXXXXXX---------------------------------------------------------------------------------------------
