----------------------------------------------------------------------------------------------------------------------------------------------------------------------------
----------------------------------------------------------------------------------------------------------------------------------------------------------------------------
----------------------------------------------------------------------------------------------------------------------------------------------------------------------------
----------------------------------------------------------------------------------------------------------------------------------------------------------------------------
----------------------------------------------------------------------------------------------------------------------------------------------------------------------------
----------------------------------------------------------------------------------------------------------------------------------------------------------------------------
--------------------------------SSSSS---SSS!--------------------------------------------------------------------------------------------------------------------------------
---------g------------------------------------------------------------------------------------------------------------------------------------------------------------------
-------SSSSSSSS---SSS!------------------------------------------------------------------------------------------------------------------------------------------------------
-1--------------------------------------------------------------------------------------#####------1------------------------------------------------------------------------
------g-------------------tt---------------C-----#------------SS!S--------------#----#-######-------------------!-----------------##-------#------------------##---SS------#
--------------------------tt---------------------##-------------------tt-------##---#########---------------------------tt-------###-------##----------------###----------##
----S@S--------------C----tt----------------tt-#-###-----tt-----------tt------###--##########---------------------------tt------####-------###--tt---tt-#---####---------###
-M---------------g-g-tt---tt---------g-g----tt##-####----tt-----------tt-g---#####----------------g-g-tt----------------tt-g---#####---gg--####-tt---tt##--#####-g-g----####
XXXXXXXXXXXXX-XXXXXXXXXXXXXXXXXXXXXXXXXXXXXXXXXX-XXXXXXXXXXXXXXXXXXXXXXXXXXXXXXXXX-XXXXXXXXXX--XXXXXXXXXXXXXXXXXXXXXXXXXXXXXXXXXXXXX-XXXXX-XXXXXXXXXXXXXXXXXXXXX-XXXXXXXXXXX
XXXXXXXXXXXXX-XXXXXXXXXXXXXXXXXXXXXXXXXXXXXXXXXX-XXXXXXXXXXXXXXXXXXXXXXXXXXXXXXXXX-XXXXXXXXXX--XXXXXXXXXXXXXXXXXXXXXXXXXXXXXXXXXXXXX-XXXXX-XXXXXXXXXXXXXXXXXXXXX-XXXXXXXXXXX
