-------------------------------------------------------------------------------------------------------------------------------------------------------------------------------------------
-------------------------------------------------------------------------------------------------------------------------------------------------------------------------------------------
-------------------------------------------------------------------------------------------------------------------------------------------------------------------------------------------
-------------------------------------------------------------------------------------------------------------------------------------------------------------------------------------------
-------------------------------------------------------------------------------------------------------------------------------------------------------------------------------------------
-------------------------------------------------------------------------------------------------------------------------------------------------------------------------------------------
-SSSSS---SSS!------------------------------------------------------------------------------------------------------------------------------------------------------------------------------
--------------------------------------------------------------------------------------------------------------------------------1----------------------------------------------------------
-----------------------------tt-----------tt-----------------------------------------------------------------------------------------------------------------------------------------------
-----------------------------tt-----------tt-----------------------------------------------------------------------------------------------------------------------------------------------
------------C!-----#--#------tt-----------tt----SU-----------!-----#--#----------##---------!-----SS------#--#--------tt-------------------!---#-------SS----#-------!-----#--#--------!---
------------------##--##------------------------------------------##--##--------###----------------------##--##-------tt-----------------------##------------##-----------##--##-----------
-----------------###--###---------------------------XTT----------###--###------####---------------------###--###------tt--XTT------------------###-----------###---------###--###----------
-M-----------k--####--####----g-g----gg--------------tt------k--####--####----#####---gg--------g-g----####--####-----tt---tt--------------k---####--g-g-----####----k--####--####---------
XXXX---XXXXXXXXXXXXXXXXXXXXXXXXXXXXXXXXXX---XXXXXXXXXXXXXXXXXXXXXXXXXXXXXXXXXXXXXXX-XXXXXXXXXXXXXXXXXXXXXXXXXXXXXXXXXXXXXXXXXXXXXX---XXXXXXXXXXXXXXXXXXXXXXXXXXXXXXXXXXXXXXXXXXXXXXXXXXXXXX
XXXX---XXXXXXXXXXXXXXXXXXXXXXXXXXXXXXXXXX---XXXXXXXXXXXXXXXXXXXXXXXXXXXXXXXXXXXXXXX-XXXXXXXXXXXXXXXXXXXXXXXXXXXXXXXXXXXXXXXXXXXXXX---XXXXXXXXXXXXXXXXXXXXXXXXXXXXXXXXXXXXXXXXXXXXXXXXXXXXXX
