--------------------------------------------------------------------------------------------------------------------------------------------------------------------------
--------------------------------------------------------------------------------------------------------------------------------------------------------------------------
--------------------------------------------------------------------------------------------------------------------------------------------------------------------------
--------------------------------------------------------------------------------------------------------------------------------------------------------------------------
-----------------------------------------------------------------------------------------------------------------------------------SSSSS----------------------------------
--------------------------------------------------------------------------------------------------------------------------------------------------------------------------
--------------------------------------------------------------------------------------------------------------------------------------------------------------------------
--------------------------------------------------------------------------------------------------------------------------------------------------------------------------
----------SSS!-------------------------------------------------------------##------------------------SSS!-----------------------------------------------------------------
--------------------------------------------------------------------------###-----------------------------------------------------#----------1----------------------------
-----------------------------SS!S--!-----#--#-----SU-----!----------SS!--####------!---SU------------------#----------S@S!S------##-----##------------#--------#----------
----------------------tt----------------##--##-------------------------------------------------------------##-------------------###----###------------##-------##---------
-------------C--------tt---------------###--###----------------------------------------------tt-#-------C--###-----tt-----------###---####------------###--tt--###-----tt-
-M---gg-#######-------tt-g---------k--####--####---------------------------------------------tt##---g-g-tt-####----tt--g-------------#####-#######----####-tt--####----tt-
XXXXXXXXXXXXXXXXXXXXXXXXXXXXXXXXXXXXXXXXXXXXXXXXXXXXXXXXXXXXXXXXXXXXXXXXX---XXXXXXXXXXXXXXXXXXXXXXXXXXXXXX-XXXXXXXXXXXXXXXXXXXXXXXXXXXXXXX-XXXXXXXXXX-XXXXXXXX-XXXXXXXXXXX
XXXXXXXXXXXXXXXXXXXXXXXXXXXXXXXXXXXXXXXXXXXXXXXXXXXXXXXXXXXXXXXXXXXXXXXXX---XXXXXXXXXXXXXXXXXXXXXXXXXXXXXX-XXXXXXXXXXXXXXXXXXXXXXXXXXXXXXX-XXXXXXXXXX-XXXXXXXX-XXXXXXXXXXX
