----------------------------------------------------------------------------------------------------------------------------------------------------------------------------
----------------------------------------------------------------------------------------------------------------------------------------------------------------------------
----------------------------------------------------------------------------------------------------------------------------------------------------------------------------
----------------------------------------------------------------------------------------------------------------------------------------------------------------------------
----------------------------------------------------------------------------------------------------------------------------------------------------------------------------
----------------------------------------------------------------------------------------------------------------------------------------------------------------------------
--------------------------------------------------------------------------------SSSSS---SSS!--------------------------------------SSS!--------------------------------------
----------------------------------------------------------------------------------------------------------------------------------------------------------------------g-----
---------------------------SSSSS---SSS!-----------------------------------------------------------------------------------------------------------------SSSSS-------SSSSSSSS
--------------------------------------------------------------------------------------------------------------------------------------------------1-------------------------
-----------SS!S-----##-------------------S@S!S-------##---!-----#--#-----SU----------------C!-----#--#--------!--------##--#---------C-----------------------------g--------
-------------------###------------------------------###--------##--##----------------------------##--##---------------###--##-----------------------------------------------
-----tt-#---------####----------------C------------####-------###--###---------tt-#-------------###--###-------------####--###--tt-------------------------------S@S--------
-M---tt##--------#####---------#######----g-------#####---k--####--####--------tt##--g-g----k--####--####-----------#####--####-tt-------------tt-g-------------------------
XXXXXXXXXXXXXXXXXXXXXX-XXXXXXXXXXXXXXXXXXXXXXXXXXXXXXXX-XXXXXXXXXXXXXXXXXXXXXXXXXXXXXXXXXXXXXXXXXXXXXXXXXXXXXXXXXXXXXXXXX--XXXXXXXXX---XXXXXXXXXXXXXXXXXXXXXXX--XXXXXXXXXX--
XXXXXXXXXXXXXXXXXXXXXX-XXXXXXXXXXXXXXXXXXXXXXXXXXXXXXXX-XXXXXXXXXXXXXXXXXXXXXXXXXXXXXXXXXXXXXXXXXXXXXXXXXXXXXXXXXXXXXXXXX--XXXXXXXXX---XXXXXXXXXXXXXXXXXXXXXXX--XXXXXXXXXX--
