----------------------------------------------------------------------------------------------------------------------------------------------------------------------------
----------------------------------------------------------------------------------------------------------------------------------------------------------------------------
----------------------------------------------------------------------------------------------------------------------------------------------------------------------------
----------------------------------------------------------------------------------------------------------------------------------------------------------------------------
----------------------------------------------------------------------------------------------------------------------------------------------------------------------------
---------1------------------------------------------------------------------------------------------------------------------------------------------------------------------
----------------------------------------------------------------------------------------------------------------------------------------------------------------------------
--------------------------------------------------------------------------------------------------------------------------------1-------------------------------------------
------------------------------------tt--------------------------------SSS!--------------------------------------------------------------------------------------------------
----------#####---------------------tt--------------------------------------------------------------------------------------------------------------------------------------
---------######-----SS------#--#----tt--------------SU----tt----------------#-------------!-----SS------#--#-----SU---#-------------------#----------tt-------S@S!S---------
--------#######------------##--##-------------------------tt----------------##-------------------------##--##---------##------------------##---------tt---------------------
--------#######-----------###--###-----------XTT----------tt-------------C--###-----tt----------------###--###--------###-----tt----------###--tt----tt---------------------
-M---gg-#######---g-g----####--####-----------tt--------#######------g-g-tt-####----tt--------g-g----####--####-------####----tt----------####-tt----tt----gg--g-------g-g--
XXXXXXXXXXXXXXXXXXXXXXXXXXXXXXXXXXXXXX---XXXXXXXXXXXXXXXXXXXXXXXXXXXXXXXXXX-XXXXXXXXXXXXXXXXXXXXXXXXXXXXXXXXXXXXXXXXX-XXXXXXXXXXXX---XXXX-XXXXXXXXXXXXXXXXXXXXXXXXXXXXXXXXXX
XXXXXXXXXXXXXXXXXXXXXXXXXXXXXXXXXXXXXX---XXXXXXXXXXXXXXXXXXXXXXXXXXXXXXXXXX-XXXXXXXXXXXXXXXXXXXXXXXXXXXXXXXXXXXXXXXXX-XXXXXXXXXXXX---XXXX-XXXXXXXXXXXXXXXXXXXXXXXXXXXXXXXXXX
