-------------------------------------------------------------------------------------------------------------
---------------------------------------------------------------------------g---------------------------------
-------------------------------------------------------------------------SSSSSSSS---SSS----------------------
---------------------------g-------------------------------------------------------------#####------1--------
-------------------------SSSSSSSS---------------------------------------g---------------######---------------
---------------------------------------------------------------------------------------#######---------------
--------------------S---g---------------------##----------------------S@S--------------#######---------------
---------------------------------------------###---------------------------#####-----------------------------
------------SSS!------S@S-------------------####--------------------------######----XXXXXXXXXX---------------
---------------------------#####-----------#####------1------------------#######----XXXXXXXXXX---------------
-----------------------C--######-----tt---######------------#------------#######------------##---S---X---XXXX
-------------------------#######-----tt--#######------------##-----------------------------###-------X---XXXX
---------------C---------#######-----tt--#######------------###-----tt---tt-#-------------####---------------
-M---------g-g-tt--gg---g-g--------------------------g-g-tt-####----tt---tt##--g-g-----g-g-tt-g----------#---
XXXXXXXXXXXXXXXXXXXXXXXXXXXXXXXXXXXXXXXXXXXXXXXX--XXXXXXXXX-XXXXXXXXXXXXXXXXXXXXXXXXXXXXXXXXXXXXXXXXXXXXXXXXX
XXXXXXXXXXXXXXXXXXXXXXXXXXXXXXXXXXXXXXXXXXXXXXXX--XXXXXXXXX-XXXXXXXXXXXXXXXXXXXXXXXXXXXXXXXXXXXXXXXXXXXXXXXXX
