-----------------------------------------------------------------------------------------------------------------------------------------------------------------------------------------
-----------------------------------------------------------------------------------------------------------------------------------------------------------------------------------------
-----------------------------------------------------------------------------------------------------------------------------------------------------------------------------------------
-----------------------------------------------------------------------------------------------------------------------------------------------------------------------------------------
-----------------------------------------------------------------------------------------------------------------------------------------------------------------------------------------
-----------------------------------------------------------------------------------------------------------------------------------------------------------------------------------------
---------------SSS!--------------------------------------------------------------------------------------------------------------------------------------tt------------------------------
------1-------------------------------------------1-----------------------------------------------------------------1------------------------------------tt------------------------------
---------------------------------------------------------------------------------------------------------------------------------------------------------tt------------------------------
-------------------------------------------------------------------------------------------------------------------------------------------------------#####------1----------------------
------------------C--------##--#---------!---#------------------------------##---------#----------tt-------##-S@S---------------------SS----#---------######--------------------------##-
--------------------------###--##------------##----------------tt----------###---tt----##---------tt------###-------------------------------##-------###-----------------------------###-
-------------------------####--###--tt-------###---------------tt---------####---tt----###--tt----tt-----####-------------------------------###------###----------------------------####-
-M---------------g-g----#####--####-tt---k---####--------------tt-g----g-g-tt----tt-g--####-tt----tt----#####--g---------------g-g--g-g-----####----------------#######-----g-g----#####-
XXXXXXXX---XXXXXXXXXXXXXXXXXX--XXXXXXXXXXXXXXXXXXXXX---XXXXXXXXXXXXXXXXXXXXXXXXXXXXXXX-XXXXXXXXXXXXXXXXXXXXXX-XXXXXXXX---XXXXXXXXXXXXXXXXXXXXXXXXXXXXXXXX---XXXXXXXXXXXXXXXXXXXXXXXXXXXX-
XXXXXXXX---XXXXXXXXXXXXXXXXXX--XXXXXXXXXXXXXXXXXXXXX---XXXXXXXXXXXXXXXXXXXXXXXXXXXXXXX-XXXXXXXXXXXXXXXXXXXXXX-XXXXXXXX---XXXXXXXXXXXXXXXXXXXXXXXXXXXXXXXX---XXXXXXXXXXXXXXXXXXXXXXXXXXXX-
