------tt--#######-----------tt---######-----------------------------------------------------------------
-------#####----------------tt--#######-----------------------------------------------------------------
-tt---######-----------tt-#-tt--#######-----------------------------------------------------------------
-tt--#######----g-g----tt##---------------------###------1----------------------------------------------
-tt--#######---XXXXXXXXXXXXXXXXXXXXXX--XXXXXXX--###-----------------------------------------------------
---------------------XXXXXXXXXXXXXXXX--XXXXXXX--###-----------------------------------------------------
----------XXXXXXXXX-------------------------#######-----------------------------------------------------
----------XXXXXXXXX---------------------------------------#####-----------------------------------------
--X---XXXX---SSSS----------------------------------------######-----------------------------------------
--X---XXXX--------------#####------1--------------------#######----------------------------------1------
---------------------#-######-------------!---#--------t#######-------tt-------------S@S!S--------------
--------------------#########-----------------##-------tt-------------tt--------------------------------
---XTT-------------##########-----------------###------tt-------------tt---------tt-#-------------------
-M--tt-------g-g-tt---------------g-g-tt--k---####-----tt-------------tt---------tt##-g-----------------
XXXXXXXXXXXXXXXXXXXXXXXXXXXXX--XXXXXXXXXXXXXXXXXXXXXXXXXXXXX---XXXXXXXXXXXXXXXXXXXXXXXXXXXXXXXXXXXXXXX--
XXXXXXXXXXXXXXXXXXXXXXXXXXXXX--XXXXXXXXXXXXXXXXXXXXXXXXXXXXX---XXXXXXXXXXXXXXXXXXXXXXXXXXXXXXXXXXXXXXX--
