----------------------------------------------------------------------------------------------------------------------------------------------------------------------------------------------
----------------------------------------------------------------------------------------------------------------------------------------------------------------------------------------------
----------------------------------------------------------------------------------------------------------------------------------------------------------------------------------------------
----------------------------------------------------------------------------------------------------------------------------------------------------------------------------------------------
----------------------------------------------------------------------------------------------------------------------------------------------------------------------------------------------
----------------------------------------------------------------------------------------------------------------------------------------------------------------------------------------------
----------------------------------------------------------------------------------------------------------------------------------------------------------------------------------------------
---------------------------------------------------1---------------------------------------------1--------------------------------------------------------------------------------------------
-----------------------------------------------------------------tt------------------------------------------------------SSSSS---SSS!-----SSSSS---SSS!----------------------------------------
-----------------------------------------------------------------tt----------------------------------------------------------------------------------------------------------------------1----
-----SS!S----------!-----!-----#--#----------S@S-----------------tt-------S@S!S-------------------------------------------------------------------------SU-----------S@S!S--------------------
------------------------------##--##----------------------------------------------------------------------------------------------------------------------------tt--------------tt------------
---------XTT-----------------###--###--------------------------------------------XTT-----------------------------tt-#---------------C----------------C----------tt--------------tt------------
-M--------tt-------------k--####--####----gg--g----------------------------g------tt-----------gg----------------tt##-------------------------#######-----------tt-g--g---------tt-g----g-g-tt
XXXXXXXXXXXXXXXXXXXXXXXXXXXXXXXXXXXXXXXXXXXXXXXXXXXXX---XXXXXXXXXXX---XXXXXXXXXXXXXXXXXXXXXXXXXXXXX---XXXXXXXXXXXXXXXXXXXXXXXXX----XXXXXXXXXX-XXXXXXXXXXXXXXXXXXXXXXXXXXXXXXXXXXXXXXXXXXXXXXXX
XXXXXXXXXXXXXXXXXXXXXXXXXXXXXXXXXXXXXXXXXXXXXXXXXXXXX---XXXXXXXXXXX---XXXXXXXXXXXXXXXXXXXXXXXXXXXXX---XXXXXXXXXXXXXXXXXXXXXXXXX----XXXXXXXXXX-XXXXXXXXXXXXXXXXXXXXXXXXXXXXXXXXXXXXXXXXXXXXXXXX
