-----------------------------------------------------------------------------------------------------------------------------------------------------------------------
-----------------------------------------------------------------------------------------------------------------------------------------------------------------------
-----------------------------------------------------------------------------------------------------------------------------------------------------------------------
-----------------------------------------------------------------------------------------------------------------------------------------------------------------------
----------------------------------------------------------------------------------------------------------------------------------SSSSS--------------------------------
-----------------------------------------------------------------------------------------------------------------------------------------------------------------------
-------------------------------------tt------------------------------------------------SSSSS---------------------------------------------------------------------------
-------------------------------------tt--------------------------------------------------------------------------------------------------------------------------------
-------------------------------------tt---------------------------------------------------------------------------SSSSS-----S!--------------------SSSSS---SSS!---------
-----------------------------------#####------1----------------------------------------------------------------------------------#####------1--------------------------
--------##-SU-------##-SU---------#S--------------------!-----#--#-----S@S!S----------t----------------------##-----------------######---------------------------------
-------###---------###-----------##--------------------------##--##-------------------tt--------------------###----------------#######---------------------------------
------####--------####-------tt-###-------------------------###--###------------------tt-------------------####----------tt--C-#######-----------------------C---------
-M---#####-------#####-------tt##--------gg-#######-----k--####--####---g-------------tt----g-g--#######-----------------tt---------#######-------------#######--------
XXXXXXXXXX-XXXXXXXXXXX-XXXXXXXXXX--XXXXXXXXXXXXXXXXXXXXXXXXXXXXXXXXXXXXXXXXXXXXXXXXXXXXXXXXXXXXXXXXXXXXXXXXXXXXXXXXXX---XXXXXXXXXXXXXXXXXXXXXXXXXXXXXXXXXXXXXXXXXXXXXXX
XXXXXXXXXX-XXXXXXXXXXX-XXXXXXXXXX--XXXXXXXXXXXXXXXXXXXXXXXXXXXXXXXXXXXXXXXXXXXXXXXXXXXXXXXXXXXXXXXXXXXXXXXXXXXXXXXXXX---XXXXXXXXXXXXXXXXXXXXXXXXXXXXXXXXXXXXXXXXXXXXXXX
