--------------------------------------------------------------------------------------------------------------------------------------------------------------------
--------------------------------------------------------------------------------------------------------------------------------------------------------------------
--------------------------------------------------------------------------------------------------------------------------------------------------------------------
--------------------------------------------------------------------------------------------------------------------------------------------------------------------
--------------------------------------------------------------------------------------------------------------------------------------------------------------------
--------------------------------------------------------------------------------------------------------------------------------------------------------------------
------------------tt----------------------------SSS!-------------------------------------------------------------------------------------------------------SSS!-----
------------------tt------------------------------------------------------------------------------------------------------------------------------------------------
------------------tt------------------------------------------------------------------------SSS!SSSSS---SSS!--------------------------------------------------------
----------------####-------1--------------------------------------------------------------------------------#####------------1--------------------------------------
--------##-----#####-------------------------------C----------------!-----#--#-----SU----------------------######-----tt--------------#------------!---#------C-----
-------###----######-------------------tt--------------------tt----------##--##---------------------------#######-----tt--------------##---------------##-----------
------####----######-------------------tt--------------------tt---------###--###---------------C----------#######-----tt--------------###-----tt-------###----------
-M---#####---------------#######-------tt-g---------g-g------tt-g---k--####--####-------------------#######----------------#######----####----tt---k---####----g-g--
XXXXXXXXXX-XXXXXXXXXXXXXXXXXXXXXXXXXXXXXXXXXXXXXXXXXXXXXXXXXXXXXXXXXXXXXXXXXXXXXXXXXXXXXXXXXXXXXXXXXXXXXXXXXXXXXXXXXXXXX---XXXXXXXXXX-XXXXXXXXXXXXXXXXXXXXXXXXXXXXXX
XXXXXXXXXX-XXXXXXXXXXXXXXXXXXXXXXXXXXXXXXXXXXXXXXXXXXXXXXXXXXXXXXXXXXXXXXXXXXXXXXXXXXXXXXXXXXXXXXXXXXXXXXXXXXXXXXXXXXXXX---XXXXXXXXXX-XXXXXXXXXXXXXXXXXXXXXXXXXXXXXX
