-----------------------------------------------------------------------------------------------------------------------------------------------------------------------------------
-----------------------------------------------------------------------------------------------------------------------------------------------------------------------------------
-----------------------------------------------------------------------------------------------------------------------------------------------------------------------------------
-----------------------------------------------------------------------------------------------------------------------------------------------------------------------------------
-----------------------------------------------------------------------------------------------------------------------------------------------------------------------------------
-----------------------------------------------------------------------------------------------------------------------------------------------------------------------------------
------------------------------------------------------------------------------------------SSSSS-----------------------------------------SSSSS--------------------------------------
-----------------------------------------------------------------------------------------------------------------------------------------------------------------------------------
--------------------------------------------tt---------------------------SSSSS--SSSSS---SS-------------------------tt--------------------------------------------------------------
--------------------------------------------tt---------------------------------------------------------------------tt--------------------------------------------------------------
------------SS!S--SS------#--#--------!-----tt------SS----#----------S@S!-----------------------------------#------tt--------#---------S----------SU-----tt--S@S!S-----------------
-------------------------##--##---------------------------##------------------------------------------------##---------------##--------------------------tt-------------------tt---
---XTT------------------###--###--------------------------###------------------------------C--------XTT-----###--tt----------###--tt---------------------tt-----------tt-#----tt---
-M--tt----------g-g----####--####-----------------g-g-----####----gg--g----------------g-g-tt--g-g---tt-----####-tt----------####-tt---------g-g---------tt---g-------tt##----tt-g-
XXXXXXXXXXXXXXXXXXXXXXXXXXXXXXXXXXXXXXXXXXX---XXXXXXXXXXXXXXXXXXXXXXXXXXXXXXXXXXXXXXXXXXXXXXXXXXXXXXXXXXXXX-XXXXXXXXX---XXXX-XXXXXXXXXXXXXXXXXXXXXXXXXXXXXXXXXXXXXXXXXXXXXXXXXXXXXX
XXXXXXXXXXXXXXXXXXXXXXXXXXXXXXXXXXXXXXXXXXX---XXXXXXXXXXXXXXXXXXXXXXXXXXXXXXXXXXXXXXXXXXXXXXXXXXXXXXXXXXXXX-XXXXXXXXX---XXXX-XXXXXXXXXXXXXXXXXXXXXXXXXXXXXXXXXXXXXXXXXXXXXXXXXXXXXX
