--------------------------------------------------------------------------------------------------------------------------------------------------------------------------------------------------------
--------------------------------------------------------------------------------------------------------------------------------------------------------------------------------------------------------
--------------------------------------------------------------------------------------------------------------------------------------------------------------------------------------------------------
--------------------------------------------------------------------------------------------------------------------------------------------------------------------------------------------------------
--------------------------------------------------------------------------------------------------------------------------------------------------------------------------------------------------------
--------------------------------------------------------------------------------------------------------------------------------------------------------------------------------------------------------
--------------------------------------------------------------------------------------------------------------------------------------------------------------------------------------------------------
--------------------------------------------------------------------------------------------------------------------------------------------------------------------------------------------------------
-----------------------------------------------------------------------------------------------------------------------------------------------------------tt-------------------------------------------
---------------------------------------------------------------------------------------1-------------------------------------------------------------------tt-------------------------------------------
------tt----SS!S---------!---#------#-------------tt--S@S!S---#------------------SS!-------------------##--------SS!SS@S!S---#-----------------!-----------tt---------------tt--------------SS!S--------
------tt---------------------##-----##------------tt----------##--------------------------------------##---------------------##------------------------tt-------------------tt--------------------------
------tt--------XTT----------###----###-----tt----tt----------###-----tt---tt-#----------------------###---------------------###--tt-XTT---------------tt-------------------tt--------------------------
-M----tt---------tt------k---####---####----tt----tt---g------####----tt---tt##------#######------g-g-tt--g-g---------g------####-tt--tt---------------tt-g-----------------tt--#######-----------------
XXXXXXXXXXXXXXXXXXXXXXXXXXXXXXXXXXX-XXXXXXXXXXXXXXXXXXXXXXXXX-XXXXXXXXXXXXXXXXXXXXXXXXXXXXXXXXXXXXXXXXXXXXXXXXXXXXXXXXXXXXXX-XXXXXXXXXXXXXXXXXXXXXXXXXXXXXXXX---XXXXXXXXXXXXXXXXXXXXXXXXXXXXXXXXX---XXXX
XXXXXXXXXXXXXXXXXXXXXXXXXXXXXXXXXXX-XXXXXXXXXXXXXXXXXXXXXXXXX-XXXXXXXXXXXXXXXXXXXXXXXXXXXXXXXXXXXXXXXXXXXXXXXXXXXXXXXXXXXXXX-XXXXXXXXXXXXXXXXXXXXXXXXXXXXXXXX---XXXXXXXXXXXXXXXXXXXXXXXXXXXXXXXXX---XXXX
