----------------------------------------------------------------------------------------------------------------------------------------------------------------
----------------------------------------------------------------------------------------------------------------------------------------------------------------
----------------------------------------------------------------------------------------------------------------------------------------------------------------
----------------------------------------------------------------------------------------------------------------------------------------------------------------
-------------------------SSSSS---SSS!---------------------------------------------------------------------------------------------------------------------------
----------------------------------------------------------------------------------------------------------------------------------------------------------------
--------------------------------------------------------------------------------------------------------------------------------tt------------------------------
--------------------------------------------------------------------------------------------------------------------------------tt------------------------------
--------------------------------------------SSSSS---SSS!-----------------------------------------------------------SSSS---------tt------------------------------
---------------------------#####-------------------------------------1-----------------------------------------------------------#####--------------------------
------!----#--------------######------------------------------tt---------------------------##----------------##------------tt---######--!---#----------------##-
-----------##------------#######------------------------------tt-----------------tt-------###---------------###------------tt--#######------##--------------###-
-----------###-----tt----#######-----tt----------------C------tt-----------------tt------####-XTT----------####------------tt--#######------###-----tt-#---####-
-M---------####----tt----------------tt----------------------------#######-------tt-g---#####--tt-------g-g-tt------------------g-g-tt--k---####----tt##--#####-
XXXXXXXXXX-XXXXXXXXXXXXXXXXXXXXX----XXXXXXXXXXXXXXXXXXXXXXXXXXXX---XXXXXXXXXXXXXXXXXXXXXXXXXX-XXXXXXXXXXXXXXXXXXXXXXXXXXXXXXXXXXXXXXXXXXXXXXXXXXXXXXXXXXXXXXXXX-
XXXXXXXXXX-XXXXXXXXXXXXXXXXXXXXX----XXXXXXXXXXXXXXXXXXXXXXXXXXXX---XXXXXXXXXXXXXXXXXXXXXXXXXX-XXXXXXXXXXXXXXXXXXXXXXXXXXXXXXXXXXXXXXXXXXXXXXXXXXXXXXXXXXXXXXXXX-
