--------------------------------------------------------------------------------------------------------------------------------------------------------------------------------------------------
--------------------------------------------------------------------------------------------------------------------------------------------------------------------------------------------------
--------------------------------------------------------------------------------------------------------------------------------------------------------------------------------------------------
--------------------------------------------------------------------------------------------------------------------------------------------------------------------------------------------------
---------SSSSS------------------------------------------------------------------------------------------------------------------------------------------------------------------------------------
--------------------------------------------------------------------------------------------------------------------------------------------------------------------------------------------------
--------------------------------------------------------------------------------------------------------------------------------------------------------------------------------------------------
--------------------------------------------------------------------------------------------------------------------------------------------------------------------------------------------------
-SSS!---------------------------------------------------------------------------------------SSS!---------------------------------------------------------------------------------------SSSSS------
--------#####------1------------------------------------------------------------------------------------------------------------------------------------------------------------------------------
-------######-------------tt--------------------------------------tt------------#--------------------tt-----!------tt----------##-------#-------!-----#--#----------##---!---#----------------#---
------#######-------------tt------------------------------tt------tt------tt----##-------------------tt------------tt---------###-------##-----------##--##--------###-------##---------------##--
----C-#######-------------tt------XTT------tt-#XTT--------tt------tt------tt----###--tt--------C-----tt------------tt--------####-------###---------###--###------####-------###--------------###-
-M----------------g-g-tt#######----tt------tt##-tt--------tt-g----tt------tt-g--####-tt-#######------tt------------tt-----g-g-ttg-g-----####----k--####--####----#####---k---####--#######----####
XXXXXXXXXXXXX--XXXXXXXXXXXXXXXXXXXXXXXXXXXXXXXXXXXXXXXXXXXXXXXXXXXXXXXXXXXXXXXX-XXXXXXXXXXXXXXXXXXXXXXXXXXXXXXXXXXXXXXXXXXXXXXXXXXXXXXXXXXXXXXXXXXXXXXXXXXXXXXXXXXXXXX-XXXXXXXXXXXXXXXXXXXXXX-XXXX
XXXXXXXXXXXXX--XXXXXXXXXXXXXXXXXXXXXXXXXXXXXXXXXXXXXXXXXXXXXXXXXXXXXXXXXXXXXXXX-XXXXXXXXXXXXXXXXXXXXXXXXXXXXXXXXXXXXXXXXXXXXXXXXXXXXXXXXXXXXXXXXXXXXXXXXXXXXXXXXXXXXXX-XXXXXXXXXXXXXXXXXXXXXX-XXXX
