-----------------------------------------------------------------------------------------------------------------------------------------------------------------------------------------------
-----------------------------------------------------------------------------------------------------------------------------------------------------------------------------------------------
-----------------------------------------------------------------------------------------------------------------------------------------------------------------------------------------------
-----------------------------------------------------------------------------------------------------------------------------------------------------------------------------------------------
---------------------------SSS!----------------------------------------------------------------------------------------------------------------------------------------------------------------
-----------------------------------------------------------------------------------------------------------------------------------------------------------------------------------------------
----------------------------------------------------------------------------------------------------------------SSS!---------------------------------------------------------------------------
-----------------------------------------------------------------------------------------------------------------------------------------------------------------------------------------------
--------------------------------------------------------------------------------------------------------SSS!----------------------SSSSS--------------------------------------------------------
--------------------------##---------1---------------------------------------------------------------------------------------------------------------------------------------------------------
--------------------tt---###S@S!S-----------------------tt--------SS----#-------SS------#--#-----------------------C------tt-------------------------tt--------------------##------------------
-------tt-----------tt--####---------------------tt-----tt--------------##-------------##--##-----------------------------tt-------------------------tt-------------------###-------------tt---
-------tt-----------tt--####---------------------tt-----tt--------------###-----------###--###-------------C--------------tt-------------------------tt-------XTT--------####---TT--------tt---
-M-----tt-g------------------g-----#######-------tt-g-#######---g-g-----####--g-g----####--####----gg-#######-----g-g-----tt--#######-----gg---------tt--------tt----#######----tt--------tt-g-
XXXXXXXXXXXXXXXXXXXXXXXXXXXXXXXXXXXXXXXXXXXXXXXXXXXXXXXXXXXXXXXXXXXXXXXXXXXXXXXXXXXXXXXXXXXXXXXXXXXXXXXXXXXXXXXXXXXXXXXXXXXXXXXXXXXXXXXXXXXXXXXXXXXXXXXXXXXXXXXXXXXXXXXXXXXXXXXXXXXXXXXXXXXXXXX
XXXXXXXXXXXXXXXXXXXXXXXXXXXXXXXXXXXXXXXXXXXXXXXXXXXXXXXXXXXXXXXXXXXXXXXXXXXXXXXXXXXXXXXXXXXXXXXXXXXXXXXXXXXXXXXXXXXXXXXXXXXXXXXXXXXXXXXXXXXXXXXXXXXXXXXXXXXXXXXXXXXXXXXXXXXXXXXXXXXXXXXXXXXXXXX
