----------------------------------------------------------------------------------------------------------------------------------------------------------------------------------------------
----------------------------------------------------------------------------------------------------------------------------------------------------------------------------------------------
----------------------------------------------------------------------------------------------------------------------------------------------------------------------------------------------
----------------------------------------------------------------------------------------------------------------------------------------------------------------------------------------------
----------------------------------------------------------------------------------------------------------------------------------------------------------------------------------------------
----------------------------------------------------------------------------------------------------------------------------------------------------------------------------------------------
-------------------------------------------------------------------------------------------------------------------SSSSS---SSS!------------SSSSS----------------------------------------------
----------------------------------------------------------------------------------------------------------------------------------------------------------------------------------------------
-------------------------------------------------------------SSS!-----------------------------------------------------------------------------------------------------------------------------
----------------------------------------------------------------------------------------------------------------------------------------------------------------------------------------------
------!--------##-----------##----------SS------#--#-----------------tt----tt--------!-----#--#-------SS!S--!---#-------------C------------------------!-----#--#-----------#-------------tt--
--------------###----------###-----------------##--##----------------tt----tt-------------##--##----------------##---------------tt-------###---------------##--##----------##------------tt--
-------------####---------####-XTT------------###--###----------C----tt----tt------------###--###---------------###--------------tt------####--------------###--###---------###-----tt----tt--
-M----------#####---gg---#####--tt----g-g----####--####-----g-g-tt---tt--#######-----k--####--####----------k---####----g-g------tt-g---#####---g-g----k--####--####----gg--####----tt----tt--
XXXXXXXXXXXXXXXXX-XXXXXXXXXXXX-XXXXXXXXXXXXXXXXXXXXXXXXXXXXXXXXXXXXXXXXXXXXXXXXXXXXXXXXXXXXXXXXXXXXXXXXXXXXXXXXXXXXXXXXXXXXXXXXXXXXXXXXXXXXXX-XXXXXXXXXXXXXXXXXXXXXXXXXXXXX-XXXXXXXXXXXXXXXXXX
XXXXXXXXXXXXXXXXX-XXXXXXXXXXXX-XXXXXXXXXXXXXXXXXXXXXXXXXXXXXXXXXXXXXXXXXXXXXXXXXXXXXXXXXXXXXXXXXXXXXXXXXXXXXXXXXXXXXXXXXXXXXXXXXXXXXXXXXXXXXX-XXXXXXXXXXXXXXXXXXXXXXXXXXXXX-XXXXXXXXXXXXXXXXXX
