-------------------------------------------------------------------------------------------------------------------------------------------------------------------------
--------------------------------------------------------------------------------------------------------------------------------------------------g----------------------
------------------------------------------------------------------------------------------------------------------------------------------------SSSSSSSS---SSS!----------
-------------------------------------------------------------------------------------------------------------------------------------------------------------------------
-----------------------------------------------------------------------------------------------------------------------------------------------g-------------------------
-------------------------------------------------------------------------------------------------------------------------------------------------------------------------
---------------------------------------------------------------------------------------------------------------------------------------------S@S--------------C----------
-----------------------------------------------------------------------------------------------------------------------------------------------------#####---------------
------------------------------SSSSS---SSS!---SSS!SSSSS---SSS!---------------------------------------------------------------------------------------######---XXXXXXXXXX--
-------------------------------------------------------------------------------------------------------------------------1-------------------------#######---XXXXXXXXXX--
-------------tt--------------------------------------------------------------##---SS----#-----S@S!S----SS!S---tt--------------------!------tt------#######---------------
-------------tt----------------------------------------------------tt-------###---------##--------------------tt---------------------------tt----------------------------
---XTT-------tt--XTT------tt-#------------------C-----------C------tt------####---------###-------------------tt---------------------------tt----------------------------
-M--tt-------tt---tt------tt##-----------------------#######-------tt-g---#####-g-g-----####---g--------------tt----gg-#######-------------tt----g-g---------------#-----
XXXXXXXXXXXXXXXXXXXXXXXXXXXXXXXXXXXXXX---XXXXXXXXXXXXXXXXXXXXXXXXXXXXXXXXXXXXXX-XXXXXXXXXXXXXXXXXXXXXXXXXXXXXXXXXXXXXXXXXXXXXXXXXXXXXXXXXXXXXXXXXXXXXXX---XXXXXXXXXXXXX--
XXXXXXXXXXXXXXXXXXXXXXXXXXXXXXXXXXXXXX---XXXXXXXXXXXXXXXXXXXXXXXXXXXXXXXXXXXXXX-XXXXXXXXXXXXXXXXXXXXXXXXXXXXXXXXXXXXXXXXXXXXXXXXXXXXXXXXXXXXXXXXXXXXXXX---XXXXXXXXXXXXX--
