-----------------------------------------------------------------------------------------------------------------------------------------------------------------------------------
-----------------------------------------------------------------------------------------------------------------------------------------------------------------------------------
-----------------------------------------------------------------------------------------------------------------------------------------------------------------------------------
-----------------------------------------------------------------------------------------------------------------------------------------------------------------------------------
-----------------------------------------------------------------------------------------------------------------------------------------------------------------------SSSSS---SSS!
-----------------------------------------------------------------------------------------------------------------------------------------------------------------------------------
-----------------------------------------------------------------------------------------------------------------------------------------------------------------------------------
-----------------------------------------------------------------------------------------------------------------------------------------------------------------------------------
--------------------------SSSSS---SSS!--------------------------------------------------------------------tt----------------------------------------------------------------------C
----------------------------------------------------------------------------------------------------------tt------------------1------------------------------------------#####-----
---S@S!S---------SU-------------------------S@S!S--SU-------------SU----------!-------------tt---#--------tt-------S@S!S----------------##-------------------------tt---######-----
--------------------------------------------------------------------------------------------tt---##------------------------------------###-------------------------tt--#######-----
----------XTT--------XTT-------------CTT-----------------tt-#---------------------XTT-------tt---###-----tt---------------------------####-------------tt-#--------tt--#######-----
-M--g------tt---------tt-------g-g-tt-tt-----g-----------tt##-----------gg---------tt-------tt---####----tt---g-g---g--------g-g-tt--#####-#######-----tt##------------------------
XXXXXXXXXXXXXXXXXXXXXXXXXXXXXXXXXXXXXXXXXXXXXXXXXXXXXXXXXXXXXXXXXXXXXXXXXXXXXXXXXXXXXXXXXXXXXXXX-XXXXXXXXXXXXXXXXXXXXXXXXXXXXXXXXXXXXXXXXX-XXXXXXXXXXXXXXXXXXXXXXXXXX--------------
XXXXXXXXXXXXXXXXXXXXXXXXXXXXXXXXXXXXXXXXXXXXXXXXXXXXXXXXXXXXXXXXXXXXXXXXXXXXXXXXXXXXXXXXXXXXXXXX-XXXXXXXXXXXXXXXXXXXXXXXXXXXXXXXXXXXXXXXXX-XXXXXXXXXXXXXXXXXXXXXXXXXX--------------
