-------------------------------------------------------------------------------------------------------------------------------------------------------------
-------------------------------------------------------------------------------------------------------------------------------------------------------------
-------------------------------------------------------------------------------------------------------------------------------------------------------------
--------------------------------------------------------------------------------------g----------------------------------------------------------------------
------------------------------------------------------------------------------------SSSSSSSS---SSS!---------------------------------SSSSS---SSS!-------------
-------------------------------------------------------------------------------------------------------------------------------------------------------------
-----------------------------------------------------------------------------------g---------------------------------------------------------------------SS!S
-------------------------------------------------------------------------------------------------------------------------------------------------------------
-------------------------------------------tt----------------------SSS!----------S@S--------------CS---SSS!--------------------------------------------------
-------------------------------------------tt--------------------------------------------#####------------------------1--------------#---g-g-tt--------------
------------------------##---!-----#--#----tt---------SS!S----------------SS------#--#--######-----------------tt---------------##---#XXXXXXXXXX---XXXXXXXXXX
-----------------------###--------##--##-----------------------------------------##--#########-----------------tt--------------###---#XXXXXXXXXX---XXXXXXXXXX
------------XTT-------####-------###--###-----------------------------C---------###--#########------------C----tt-------------####---###---------------------
-M----g-g-tt-tt------#####---k--####--####------------------------g-g-ttg-g----####--####---------------------------#######----------------------------------
XXXXXXXXXXXXXXXXXXXXXXXXXX-XXXXXXXXXXXXXXXXXX---XXXXXXXXXXXXXXXXXXXXXXXXXXXXXXXXXXXXXXXXXXXXXXXXXXXXX--XXXXXXXXXX---XXXXXXXXXXXXXXXXXXXX---------------------
XXXXXXXXXXXXXXXXXXXXXXXXXX-XXXXXXXXXXXXXXXXXX---XXXXXXXXXXXXXXXXXXXXXXXXXXXXXXXXXXXXXXXXXXXXXXXXXXXXX--XXXXXXXXXX---XXXXXXXXXXXXXXXXXXXX---------------------
