------------------------------------------------------------------------------------------------------------------------------------------------------------------------------------
------------------------------------------------------------------------------------------------------------------------------------------------------------------------------------
------------------------------------------------------------------------------------------------------------------------------------------------------------------------------------
------------------------------------------------------------------------------------------------------------------------------------------------------------------------------------
------------------------------------------------------------------------------------------------------------------------------------------------------------------------------------
------------------------------------------------------------------------------------------------------------------------------------------------------------------------------------
------------------------------------------------------------------------------------------------------------------------------------------------------------------------------------
-------------------------------------------------------------------------------------1-------------------------------------------------------------1--------------------------------
--------------------------SSSSS---SSS!----------------------------------------------------------------------------------------------------------------------------------------------
----------------#---1---------------------------------------------------------------------------------------------------------------------------------------------------------------
-----------tt--##------------------------SS!SSU-----!-----------##---!SS@S!S---#-------------------##---------!---#--------------S@S!S-----------------------------SS!S-----##------
-----------tt--------------------------------------------------###-------------##-----------------###-------------##--------tt---------------------------------------------###------
-----------tt------------------------C------------------------####-------------###--tt-----------####---tt-#------###-------tt----------XTT-------------------------------####------
-M---------tt----g-g-------------g-g-tt--------------------g-g-tt-------g------####-tt---g-g----#####---tt##--k---####------tt-g--g------tt-------------------gg---------#####---gg-
XXXXXXXXXXXXXXXXXXXXXXXXXXXXXXXXXXXXXXXXXXXXXXXXXXXXXXXXXXXXXXXXXXXXXXXXXXXXXX-XXXXXXXXXXXXXXXXXXXXXX-XXXXXXXXXXXXXXXXXXXXXXXXXXXXXXXXXXXXXXXXXXXXXXX---XXXXXXXXXXXXXXXXXXXXXX-XXXXX
XXXXXXXXXXXXXXXXXXXXXXXXXXXXXXXXXXXXXXXXXXXXXXXXXXXXXXXXXXXXXXXXXXXXXXXXXXXXXX-XXXXXXXXXXXXXXXXXXXXXX-XXXXXXXXXXXXXXXXXXXXXXXXXXXXXXXXXXXXXXXXXXXXXXX---XXXXXXXXXXXXXXXXXXXXXX-XXXXX
