--------------------tt-#-------------------------------------------------------------------------------------------
-------------g-g----tt##----#####---####------1----------------1---------------------------------------------------
XXXXXXXXXXXXXXXXXXXXXXXX---######---####----------------tt---------------------------------------------------------
XXXXXXXXXXXXXXXXXXXXXXXX--#######---####----------------tt---------------------------------------------------------
--------------------------#######---####----------------tt---------------------------------------------------------
----------------------------------------------------------------#####------1---------------------------------------
------------------------------XXXXXXXXXX--------XXXXXXXXXX-----######----------------------------------------------
-----------------g------------XXXXXXXXXX--------XXXXXXXXXX----#######----------------------------------------------
---------------SSSSSS-----------------------------------------#######----------------------------------------------
----------------------------------------------------------------------------#####----------------------------------
---SU---------g---------------!--------------SS------#--#------------------######---tt----SS!S-----S@S!S-----------
--------------------------------------tt------------##--##----------------#######---tt-----------------------------
------------S@S--------tt-#-----------tt-----------###--###----------C----#######---tt-----------------------------
-M-------gg----g-g-tt--tt##-----------tt-g-g-g----####--####--#######------g-g-tt---tt--------------g----------#---
XXXXXXXXXXXXXXXXXXXXXXXXXXXXXXXXXXXXXXXXXXXXXXXXXXXXXXXXXXXXXXXXXXXXXXXXXXXXXXXXXXXXXXXXXXXXXXXXXXXXXXXXXXXXXXXXXXX
XXXXXXXXXXXXXXXXXXXXXXXXXXXXXXXXXXXXXXXXXXXXXXXXXXXXXXXXXXXXXXXXXXXXXXXXXXXXXXXXXXXXXXXXXXXXXXXXXXXXXXXXXXXXXXXXXXX
