--------------------------------------------------------------------------------g-----------------------------------------------------------------------
--------------------------------------------------------------------------------------------------------------------------------------------------------
------------------------------------------------------------------------------S@S-----------------------------------------------------------------------
-----------------------------------------------------------------------------------#####------1---------------------------------------------------------
----------------------------------------------------------------------------------######----------------------------------------------------------------
---------------------------------------------------------------------------------#######----------------------------------------------------------------
--------------------------------------------------------------------XTT------tt-########-------------SSSSS----------------------------------------------
---------------------------------------------------------------------tt------tt##--------------#####----------------------------------------------------
--------------------------------------tt-------------------------SSSXXXXXXXXXXXXX-------------######----------------------------------------------------
-----1--------------------------------tt----------------------------XXXXXXXXXXXXX------------#######----------------------------------------------------
-------------S@S!S----SS------#--#----tt----------!------------------------------tt--SU-----!#######------------------SU-------------------SU-----------
-----------------------------##--##----------------------------------------------tt---------------------------------------------------------------------
----------------------------###--###------------------XTT-----------C------------tt----------------------------XTT------------------XTT-----------------
-M-#######----g-----g-g----####--####------------------tt----#######-----g-g-----tt-----------------------g-g---tt---------------gg--tt-------------#---
XXXXXXXXXXXXXXXXXXXXXXXXXXXXXXXXXXXXXXXX---XXXXXXXXXXXXXXXXXXXXXXXXXXXXXXXXXXXXXXXXXXXXXXXXXXXXXX---XXXXXXXXXXXXXXXXXXXXXXXXXXXXXXXXXXXXXXXXXXXXXXXXXXXX
XXXXXXXXXXXXXXXXXXXXXXXXXXXXXXXXXXXXXXXX---XXXXXXXXXXXXXXXXXXXXXXXXXXXXXXXXXXXXXXXXXXXXXXXXXXXXXX---XXXXXXXXXXXXXXXXXXXXXXXXXXXXXXXXXXXXXXXXXXXXXXXXXXXX
