--------------------------------------------------------------------------------------------------------------------------------------------------------------
----------------------------------------------------------------------------------------------------------------------g---------------------------------------
--------------------------------------------------------------------------------------------------------------------SSSSSSSS---SSS!---------------------------
--------------------------------------------------------------------------------------------------------------------------------------------------------------
-------------------------------------------------------------------------------------------------------------------g------------------------------------------
--------------------------------------------------------------------------------------------------------------------------------------------------------------
-----------------------------------------------------------------------------------------------------------------S@S--------------C---------------------------
-----------------------------------------------------------g-------------------------------------------------------------#####--------------------------------
---------------------------------------------------------SSSSSSSS---SSS!-----------------------------------tt-----------######------------------SSS!-----SSS!-
-----------------------------------------------------------------------------------------------------------tt------1---#######--------------------------------
-----SS!S----------------SS----#-----------------!------g----------------------------------------#---------tt----------#######-----#--------------------------
-------------tt----------------##----------------------------------------------------------------##--------------------------------##-------------------------
-------------tt----------------###--------------------S@S--------------C-------------------------###--tt---------------------------###-----tt------C--------C-
-M-----------tt-g------g-g-----####-----g-g-tt--------------------#######----------gg--------gg--####-tt---------#######-----g-g---####----tt-----------------
XXXXXXXXXXXXXXXXXXXXXXXXXXXXXXXXXXXXXXXXXXXXXXXXXXXXXXXXXXXXXXX---XXXXXXXXXXXXXXXXXXXXXXXXXXXXXX-XXXXXXXXX---XXXXXXXXXXXXXXXXXXXXX-XXXXXXXXXXXXXXXXXXXXXXXXX--
XXXXXXXXXXXXXXXXXXXXXXXXXXXXXXXXXXXXXXXXXXXXXXXXXXXXXXXXXXXXXXX---XXXXXXXXXXXXXXXXXXXXXXXXXXXXXX-XXXXXXXXX---XXXXXXXXXXXXXXXXXXXXX-XXXXXXXXXXXXXXXXXXXXXXXXX--
