------------------------------------------------------------------------------------------------------------------------------------------------------------------------------------------------
------------------------------------------------------------------------------------------------------------------------------------------------------------------------------------------------
------------------------------------------------------------------------------------------------------------------------------------------------------------------------------------------------
------------------------------------------------------------------------------------------------------------------------------------------------------------------------------------------------
---------------------------------------------------------------------------------------------------------SSS!-----------------------------------------------------------------------------------
------------------------------------------------------------------------------------------------------------------------------------------------------------------------------------------------
-------SSSSS----------------------------------------------------------------------------------------------------------------------------------------------------------------SSS!----------------
------------------------------------------------------------------------------------------------------------------------------------------------------------------------------------------------
------------------------------------------------------------------------------------------------------------C-----------------------------------------------------------------------------------
----------------------------------------------------------------------------------------------------------#####------1--------------------------------------------------------------------------
-----SS-----------#----------tt------------#---------------------SS!S---!------tt-------S@S!S----SS!S----######--------------!-------------------SS!S-----##--#----------------C------------SS--
------------------##---------tt------tt----##-------------tt-------------------tt-----------------------#######----------------------tt------------------###--##--------------------------------
------------------###--tt----tt------tt----###-----tt-----tt-------------------tt-----------------------#######----------------------tt-----------------####--###--tt--------------XTT----------
-M----------------####-tt----tt------tt-g--####----tt-----tt-g-----------------tt--------g--------------------------g-g-tt-----------tt-g--------------#####--####-tt---gg----------tt----g-g---
XXXXXXXXXX---XXXX-XXXXXXXXXXXXXXXXXXXXXXXX-XXXXXXXXXXXXXXXXXXXXXXXXXXXXXXXXXXXXXXXXXXXXXXXXXXXXXXXXXXXXXXXXXXXX--XXXXXXXXXXXXXXXXXXXXXXXXXXXXXXXXXXXXXXXXXXX--XXXXXXXXXXXXXX---XXXXXXXXXXXXXXXXX
XXXXXXXXXX---XXXX-XXXXXXXXXXXXXXXXXXXXXXXX-XXXXXXXXXXXXXXXXXXXXXXXXXXXXXXXXXXXXXXXXXXXXXXXXXXXXXXXXXXXXXXXXXXXX--XXXXXXXXXXXXXXXXXXXXXXXXXXXXXXXXXXXXXXXXXXX--XXXXXXXXXXXXXX---XXXXXXXXXXXXXXXXX
