-----------------------------------------------------------------------------------------------------------------------------------------------------------------------------------------------
-----------------------------------------------------------------------------------------------------------------------------------------------------------------------------------------------
-----------------------------------------------------------------------------------------------------------------------------------------------------------------------------------------------
-----------------------------------------------------------------------------------------------------------------------------------------------------------------------------------------------
-----------------------------------------------------------------------------------------------------------------------------------------------------------------------------------------------
-----------------------------------------------------------------------------------------------------------------------------------------------------------------------------------------------
-----------------------------------------------------------------------------------------------------------------------------------------------------------------------------------------------
-----------------------------------------1----------------g------------------------------------------------------------------------------------------------------------------------------------
--------------------------------------------------------SSSSSSSS---SSS!SSSSS---SSS!------------------------------------------------------------------------------------------------------------
----------------------------------------------------------------------------------------------1------------------------------------------------------------------------------------------------
------tt-----!-----SS------#--#------------------------g-------------------------------tt---------------SS----#-----SU------------tt------------------S@S!S----tt---------tt--SU----SS!S---!---
------tt------------------##--##-------------------------------------------------------tt---------------------##------------------tt------tt-------------------tt---------tt-------------------
------tt-----------------###--###--------------------S@S--------------C-----------C----tt---------------------###-------XTT-------tt------tt-------------------tt---------tt-------------------
-M----tt---------g-g----####--####-----------g-g--------------------------------------------#######---g-g-----####-------tt-------tt------tt-g---g-g---g-----#######------tt-------------------
XXXXXXXXXXXXXXXXXXXXXXXXXXXXXXXXXXXXXXXXXXXXXXXXXXXXXXXXXXXXXXXXX--XXXXXXXXXX--XXXXXXXXXX---XXXXXXXXXXXXXXXXXXXXXXXXXXXXXXXXXXXXXXXXXXXXXXXXXXXXXXXXXXXXXXXXXXXXXXXXXXXXXXXXXXXXXXXXXXXXXXXXXXX
XXXXXXXXXXXXXXXXXXXXXXXXXXXXXXXXXXXXXXXXXXXXXXXXXXXXXXXXXXXXXXXXX--XXXXXXXXXX--XXXXXXXXXX---XXXXXXXXXXXXXXXXXXXXXXXXXXXXXXXXXXXXXXXXXXXXXXXXXXXXXXXXXXXXXXXXXXXXXXXXXXXXXXXXXXXXXXXXXXXXXXXXXXX
