-------------------------------------------------------------------------------------------------------------------------------------------------------------------------------------------
-------------------------------------------------------------------------------------------------------------------------------------------------------------------------------------------
-------------------------------------------------------------------------------------------------------------------------------------------------------------------------------------------
-------------------------------------------------------------------------------------------------------------------------------------------------------------------------------------------
-------------------------------------------------------------------------------------------------------------------------------------------------------------------------------------------
-------------------------------------------------------------------------------------------------------------------------------------------------------------------------------------------
-------------------------------------------------------------------------------------------------------------------------------------------------------------SSSSS-------------------------
-----------------------------------------------------------------------------------------------------------------------------------1-------------------------------------------------------
-------------------------------------------------------------------------------------------------------------------------------------------------------------------------------------------
------------------------1------------------------------------------------------------------------------------------------------------------------------------------------------------------
----------tt-----tt---------------------!---#------#--------#------------!---#-----------------------SS------#--#-----SU----------------------SS------#--#----------------------tt--S@S!S--
----------tt-----tt-------------------------##-----##-------##---------------##--------tt-------------------##--##-----------------------------------##--##---------------------tt---------
-----t----tt-----tt---------------tt-#------###----###--tt--###-----tt-------###-------tt---XTT------------###--###---------tt-#--------------------###--###-------------tt-#---tt---------
-M---tt##-------------#######-----tt##--k---####---####-tt--####----tt---k---####------tt-g--tt----g-g----####--####--------tt##--gg---g-g--g-g----####--####------------tt##---tt---g-----
XXXXXXXXXXXXXXXXXXX---XXXXXXXXXXXXXXXXXXXXXXXXXXXX-XXXXXXXX-XXXXXXXXXXXXXXXXXXXXXXXXXXXXXXXXXXXXXXXXXXXXXXXXXXXXXXXXXXXXXXXXXXXXXXXXXXXXXXXXXXXXXXXXXXXXXXXXXXXX---XXXXXXXXXXXXXXXXXXXXXXXX
XXXXXXXXXXXXXXXXXXX---XXXXXXXXXXXXXXXXXXXXXXXXXXXX-XXXXXXXX-XXXXXXXXXXXXXXXXXXXXXXXXXXXXXXXXXXXXXXXXXXXXXXXXXXXXXXXXXXXXXXXXXXXXXXXXXXXXXXXXXXXXXXXXXXXXXXXXXXXX---XXXXXXXXXXXXXXXXXXXXXXXX
