------------------------------------------------------------------------------------------------------------------------------------------------------------------------------------------------
------------------------------------------------------------------------------------------------------------------------------------------------------------------------------------------------
------------------------------------------------------------------------------------------------------------------------------------------------------------------------------------------------
------------------------------------------------------------------------------------------------------------------------------------------------------------------------------------------------
----------------------------------------------------------SSSSS---SSS!--------------------------------------------------------------------------------------------------------------------------
------------------------------------------------------------------------------------------------------------------------------------------------------------------------------------------------
-SSSSS------------------------------------------------------------------------------------------------------------------------------------------------------------------------------------------
------------------------------------------------------------------------------------------------------------------------------------------------------------------------------------------------
---------------------------------------------------------------------C-------------------------------tt-----------------------------------------------------------------------------------------
------------------------------------------------------------#####------------------------------------tt-----------------------------------------------------------------------------------------
-----------------#--------------!---#--------tt-------SU---######---S@S!S----SS!S---!----------------tt---------SS!S--------------SU----SS------#--#-----------------tt----SS!S---tt------------
-----------------##-----------------##-------tt-----------#######---------------------------tt--------------------------tt---------------------##--##--------tt------tt-----------tt------------
-----------------###--tt------------###------tt-----------#######---------------------------tt--------------------------tt--------------------###--###-------tt------tt-----------tt------------
-M-----------gg--####-tt--------k---####-----tt----gg-----#######----g----------------------tt-g---gg-------------------tt-g----------g-g----####--####------tt-g----tt-----------tt--#######---
XXXX---XXXXXXXXX-XXXXXXXXXXXXXXXXXXXXXXXXXXXXXXXXXXXXXXXXXXXXXXXXXXXXXXXXXXXXXXXXXXXXXXXXXXXXXXXXXXXXXX---XXXXXXXXXXXXXXXXXXXXXXXXXXXXXXXXXXXXXXXXXXXXXXXXXXXXXXXXXXXXXXXXXXXXXXXXXXXXXXXXXXXXXX
XXXX---XXXXXXXXX-XXXXXXXXXXXXXXXXXXXXXXXXXXXXXXXXXXXXXXXXXXXXXXXXXXXXXXXXXXXXXXXXXXXXXXXXXXXXXXXXXXXXXX---XXXXXXXXXXXXXXXXXXXXXXXXXXXXXXXXXXXXXXXXXXXXXXXXXXXXXXXXXXXXXXXXXXXXXXXXXXXXXXXXXXXXXX
