---------------------------------------------------------------------------------------------------------------------------------------------------------------------------------------------------------
---------------------------------------------------------------------------------------------------------------------------------------------------------------------------------------------------------
---------------------------------------------------------------------------------------------------------------------------------------------------------------------------------------------------------
---------------------------------------------------------------------------------------------------------------------------------------------------------------------------------------------------------
---------------------------------------------------------------------------------------------------------------------------------------------------------------------------------------------------------
---------------------------------------------------------------------------------------------------------------------------------------------------------------------------------------------------------
---------------------------------------------------------------------------------------------------------------------------------------------------------------------------------------------------------
---------------------------------------------------------------------------------------------------------------------------------------------------------------------------------------------------------
----------------------------------------------SSS!--------------------------------------------------------------------------------------------------------------------------------------------------SSS!-
-----------------------------------------------------------------------------------------------------------------------------------------------------------1---------------------------------------------
-----SS!S---!--------------!-----#--#------------------------!--------##---------!---#-------!-----#--#----------tt------!-----tt------SU--S@S!S---------------------SS----#------#----------------------
--------------------tt----------##--##-------------------------------###-------------##-----------##--##---------tt------------tt------------------------------------------##-----##---------------------
--------------------tt---------###--###----------C-XTT--------------####---tt-#------###---------###--###--------tt------------tt-------------------tt-#-------------------###----###-----tt-----------C-
-M------------------tt-g---k--####--####-----g-g-tt-tt-------------#####---tt##--k---####----k--####--####--#######----------#######--------g-------tt##-#######---g-g-----####---####----tt-------------
XXXXXXXXXXXXXXXXXXXXXXXXXXXXXXXXXXXXXXXXXXXXXXXXXXXXXXXXXXXXXXXXXXXXXXXX-XXXXXXXXXXXXXXXXXXXXXXXXXXXXXXXXXXXXXXXXXXXXXXXXXXXXXXXXXXXXXXXXXXXXXXXXXXXXXXX-XXXXXXXXXXXXXXXXXXXXXXXX-XXXXXXXXXXXXXXXXXXXXX--
XXXXXXXXXXXXXXXXXXXXXXXXXXXXXXXXXXXXXXXXXXXXXXXXXXXXXXXXXXXXXXXXXXXXXXXX-XXXXXXXXXXXXXXXXXXXXXXXXXXXXXXXXXXXXXXXXXXXXXXXXXXXXXXXXXXXXXXXXXXXXXXXXXXXXXXX-XXXXXXXXXXXXXXXXXXXXXXXX-XXXXXXXXXXXXXXXXXXXXX--
