------------------------------------------------------------------------------------------------------------------------------------------------------------------------
------------------g-----------------------------------------------------------------------------------------------------------------------------------------------------
----------------SSSSSSSS---SSS!-----------------------------------------------------------------------------------------------------------------------------------------
------------------------------------------------------------------------------------------------------------------------------------------------------------------------
---------------g--------------------------------------------------------------------------------------------------------------------------------------------------------
------------------------------------------------------------------------------------------------------------------------------------------------------------------------
-------------S@S--------------C------------------------------------------------------------------tt---------------------------------------------------------------------
------------------#####--------------------------------------------------------------------------tt---------------------------------------------------------------------
-----------------######--------------------------------------------------------------------------tt---------------------------------------------------SSSSS-------------
----------------#######--------------------------------1------------------------------------------#####-----------------------------------------------------------------
----#----------!#######-------tt-------------------------------!-----!-----#--#------#-----------######------tt----SS------#--#-------!-----#--#------------------------
----##------------------------tt------------------------------------------##--##-----##---------#######------tt-----------##--##-----------##--##-----------------------
----###--tt-------------------tt--XTT------------------------------------###--###----###-----tt-#######------tt----------###--###---------###--###----------------------
-M--####-tt-------------------tt---tt------gg---------g-g-tt---------k--####--####---####----tt-#######------tt--g-g----####--####----k--####--####--#######--------#---
XXX-XXXXXXXXXXXXXXXX---XXXXXXXXXXXXXXXXXXXXXXXXXXXXXXXXXXXXXXXXXXXXXXXXXXXXXXXXXXXXX-XXXXXXXXXXXXXXXXXXXXXXXXXXXXXXXXXXXXXXXXXXXXXXXXXXXXXXXXXXXXXXXXXXXXXXXXXXXXXXXXXXX
XXX-XXXXXXXXXXXXXXXX---XXXXXXXXXXXXXXXXXXXXXXXXXXXXXXXXXXXXXXXXXXXXXXXXXXXXXXXXXXXXX-XXXXXXXXXXXXXXXXXXXXXXXXXXXXXXXXXXXXXXXXXXXXXXXXXXXXXXXXXXXXXXXXXXXXXXXXXXXXXXXXXXX
