-----------------------------------------------------------------------------------------------------------------------------------------------------------------------------------
-----------------------------------------------------------------------------------------------------------------------------------------------------------------------------------
-----------------------------------------------------------------------------------------------------------------------------------------------------------------------------------
-----------------------------------------------------------------------------------------------------------------------------------------------------------------------------------
-----------------------------------------------------------------------------------------------------------------------------------------------------------------------------------
-----------------------------------------------------------------------------------------------------------------------------------------------------------------------------------
--------------------------------------------------------------------------------------------------------------------------------------------------------------SSS!-----------------
-----------------------------------------------------------------------------------------------------------------------------------------------------------------------------------
--------------------------------------------------------------------------------##-----tt------------------------------------------------------------------------------------------
-------------------------------------------------------------------------------###-----tt------------------------------------------------------------------------------------------
---------------!---#----------SU-------------tt-------#-----------tt------tt--####-----tt----S@S!S---------------#--------#-----------------!---#----------------C-----------------
-------------------##-----------------tt-----tt-------##----------tt------tt-------------------------------------##-------##--------------------##--------tt-----------------------
-------------------###----------------tt-----tt-------###--tt-----tt------tt-----------------------------XTT-----###--tt--###-----tt------------###-------tt-----------------------
-M---gg--------k---####----gg---------tt-g-#######----####-tt----g-g-tt---tt----g-g-----------g-----------tt-----####-tt--####----tt---gg---k---####------tt-g-----------g-g----gg-
XXXXXXXXXXXXXXXXXXXXXXXXXXXXXXXXXXXXXXXXXXXXXXXXXXXXX-XXXXXXXXXXXXXXXXXXXXXXXXXXXXXXXX---XXXXXXXXXXXXXXXXXXXXXXX-XXXXXXXX-XXXXXXXXXXXXXXXXXXXXXXXXXXXXXXXXXXXXXX---XXXXXXXXXXXXXXXX
XXXXXXXXXXXXXXXXXXXXXXXXXXXXXXXXXXXXXXXXXXXXXXXXXXXXX-XXXXXXXXXXXXXXXXXXXXXXXXXXXXXXXX---XXXXXXXXXXXXXXXXXXXXXXX-XXXXXXXX-XXXXXXXXXXXXXXXXXXXXXXXXXXXXXXXXXXXXXX---XXXXXXXXXXXXXXXX
