-----------------------------------------------------------######---------------------######-------------------------------------------
----------------------------------------------------------#######--------------------#######-------------------------------------------
----------------------------------------------------------#######----------------tt-########----------------SSSSS---SSS!---------------
---------------------------------------------------------------------#######-----tt---g-g-tt-------#####-------------------------------
---------------------------------------------------------------------XXXXXXXXXXXXXXXXXXXXXXX------######-------------------------------
---------------------------------------------------------------------XXXXXXXXXXXXXXXXXXXXXXX-----#######-------------------------------
-------------------------------------------------------------------------------------------------#######---------------C---------------
---------------------------------------------------------------------------------------------------------------------#####-------------
----------------------------------------------------------------------##-----------------------------XXXXXXXXXX-----######-------------
---------------------------------------------------------------------###--------------1--------------XXXXXXXXXX----#######-------------
---SU----!-----#--#-------------------tt--S@S!S-----------!---------####------!--------------!---#----------------S#######-------------
--------------##--##------------------tt---------------------------------------------------------##--------tt--------------------------
-------------###--###-----tt-#--------tt-----------tt-#------------------------------------------###-------tt--------------------------
-M-------k--####--####----tt##--------tt---g-------tt##---------gg-------------------g-g-tt--k---####------tt-g--------------------#---
XXXXXXXXXXXXXXXXXXXXXXXXXXXXXXXXXXXXXXXXXXXXXXXXXXXXXXXXXXXXXXXXXXXX---XXXXXXXXXXXXXXXXXXXXXXXXXXXXXXXXXXXXXXXXXXXXXXXX---XXXXXXXXXXXXX
XXXXXXXXXXXXXXXXXXXXXXXXXXXXXXXXXXXXXXXXXXXXXXXXXXXXXXXXXXXXXXXXXXXX---XXXXXXXXXXXXXXXXXXXXXXXXXXXXXXXXXXXXXXXXXXXXXXXX---XXXXXXXXXXXXX
