------------------------------------------------------------------------------------------------------------------------------------------------------------------------
------------------------------------------------------------------------------------------------------------------------------------------------------------------------
------------------------------------------------------------------------------------------------------------------------------------------------------------------------
------------------------------------------------------------------------------------------------------------------------------------------------------------------------
------------------------------------------------------------------------------------------------------------------------------------------------------------------------
------------------------------------------------------------------------------------------------------------------------------------------------------------------------
---------------------------------------------------------------------------------------------------------------------SSSSS----------------------------------------------
------------------------------------g-----------------------------------------------------------------------------------------------------------------------------------
----------------------------------SSSSSSSS---SSS--------------------SSSSS---SSS!SSSSS---SSS!---------------------------------------SSS!---------------------------------
------------------------------------------------------------------------------------------------------------------------------------------------------------------------
---------------------------------g-----------------------S----tt---S----------------------------SS------#--#--------------------------------------##---SS!S-----##--#---
-------tt------------tt---------------------------------------tt---------------------------------------##--##------------------------------------###-----------###--##--
-------tt------------tt---XTT--S@S--------------XTT-----------tt---------------C-----------C----------###--###---XTT------------------C---------####----------####--###-
-M-----tt-g----------tt-g--tt-------------g-g-tt-tt----------------------gg---------#######---g-g----####--####---tt------g-g-----g-g-tt-------#####---------#####--####
XXXXXXXXXXXXXXXXXXXXXXXXXXXXXXXXXXXXXXXXXXXXXXXXXXXXXXXXXXXXXXXXXXXXXXXXXXXXXXXXXXXXXXXXXXXXXXXXXXXXXXXXXXXXXXXXXXXXXXXXXXXXXXXXXXXXXXXXXXXXXXXXXXXX-XXXXXXXXXXXXX--XXXX
XXXXXXXXXXXXXXXXXXXXXXXXXXXXXXXXXXXXXXXXXXXXXXXXXXXXXXXXXXXXXXXXXXXXXXXXXXXXXXXXXXXXXXXXXXXXXXXXXXXXXXXXXXXXXXXXXXXXXXXXXXXXXXXXXXXXXXXXXXXXXXXXXXXX-XXXXXXXXXXXXX--XXXX
