-------------------------------------------------------------------------------------------------------------------------------------------------------------------
------------------------------------------------------------------------------------------------------------------------------------------------------g------------
----------------------------------------------------------------------------------------------------------------------------------------SSSSS-------SSSSSSSS---SSS!
-------------------------------------------------------------------------------------------------------------------------------------------------------------------
---------------------------------------------------------------------------------------------------------------------------------------------------g---------------
-------------------------------------------------------------------------------------------------------------------------------------------------------------------
-------------------------------------------------------------------------------------------------------------------------------------------------S@S--------------C
-----------------------------------------------------------------1---------------------------------------------------------------------#####-----------------------
----------------------SSSSS---SSS!--------------------------------------------------SSSSS---SSS!--------------------------------------######----XXXXXXXXXX---------
-------------------------------------------------------------------------------------------------------------------------------------#######----XXXXXXXXXX---------
------tt---------##------------------------SS!S-----S@S!S-------------------------tt---------------------------SS!S------------##----#######-----------------------
------tt--------###---------------------------------------------------------------tt------------------------------------------###----------------------------------
------tt-------####--------------C---tt-#-----------------------------------------tt------------------XTT----------XTT-------####-XTT------------------------------
-M----tt---------------------g-g-tt--tt##--------gg--g---------------g-g----------tt-----g-g-tt--g-g---tt-----------tt------#####--tt------g-g-------#-------------
XXXXXXXXXXXXXXXXXXXXXXXXX-XXXXXXXXXXXXXXXXXXXXXXXXXXXXXXXXXX---XXXXXXXXXXXXXXXXXXXXXXXXXXXXXXXXXXXXXXXXXXXXXXXXXXXXXXXXXXXXXXXXXX-XXXXXXXXXXXXXXXXXXXXXXX----------
XXXXXXXXXXXXXXXXXXXXXXXXX-XXXXXXXXXXXXXXXXXXXXXXXXXXXXXXXXXX---XXXXXXXXXXXXXXXXXXXXXXXXXXXXXXXXXXXXXXXXXXXXXXXXXXXXXXXXXXXXXXXXXX-XXXXXXXXXXXXXXXXXXXXXXX----------
