--------------------------------------------------------------------------------------------------------------------------------------------------------------
--------------------------------------------------------------------------------------------------------------------------------------------------------------
--------------------------------------------------------------------------------------------------------------------------------------------------------------
--------------------------------------------------------------------------------------------------------------------------------------------------------------
-----------------------------------SSS!--------------------------------------------------------------------SSS!-----------------------------------------------
--------------------------------------------------------------------------------------------------------------------------------------------------------------
-----------------------------------------------------------##-------------------------------------------------------------------------------------------------
----------------------------------------------------------###-------------------------------------------------------------------------------------------------
-------------------------tt-----------C------------------####-------------------------------------------------C---------------------------SSS!-SSSSS-----SSSSS
-------------------------tt---------#####---------------#####------1--------------------------------------#####------1----------------------------------------
------tt-----!---SU------tt--------######------!----tt--#####-----------S@S!S-------##----tt-------tt----#S---------------------------------------------------
------tt--------------------------#######-----------tt--#####----------------------###----tt-------tt---##----------------------------------------------------
------tt--------------------------#######-----------tt--#####---------------------####----tt--X----tt---##---------------------tt-#----------C----------------
-M----tt--------------------------#######-------------------------g-g-tt-g-------#####----tt---tt---------------gg-#######-----tt##--gg-#######---------------
XXXXXXXXXXXXXXXXXXXXXXXXXXX---XXXXXXXXXXXXXXXXXXXXXXXXXXXXXXX--XXXXXXXXXXXXXXXXXXXXXXX-XXXXXXXXXXXXXXXXXXXXXXXXXXXXXXXXXXXXXXXXXXXXXXXXXXXXXXXXXXXXXXXXXXXXX--
XXXXXXXXXXXXXXXXXXXXXXXXXXX---XXXXXXXXXXXXXXXXXXXXXXXXXXXXXXX--XXXXXXXXXXXXXXXXXXXXXXX-XXXXXXXXXXXXXXXXXXXXXXXXXXXXXXXXXXXXXXXXXXXXXXXXXXXXXXXXXXXXXXXXXXXXX--
