------------------------------------------------------------------------------------------------------------------------------------------------------------
------------------------------------------------------------------------------------------------------------------------------------------------------------
--------------------------------------------------------------------------------------------------------------------------------SSSSS-----------------------
------------------------------------------------------------------------------------------------------------------------------------------------------------
------------------------------------------------------------------SSSSS--------------------------------------SSSSS---SSS!-----------------------------------
------------------------------------------------------------------------------------------------------------------------------------------------------------
------------------------------------------------------------------------------------------------------------------------------------------------------------
------g---------------------------------------------------------------------------------------------------------------------------#####---------------------
----SSSSSSSS------------------------------------------------------------------------------------------------------------C--------######----------#----------
--------------------------------------------------------------------#####----------------------1---------------#####------------#######----tt----##---------
---g---------------------##-----!-----SS------#--#-----------------######---!----tt----------------------tt---######------------#######----tt----###-----tt-
------------------------###------------------##--##--------tt-----#######--------tt---------tt-----------tt--#######-------------g-g-tt----tt-g--####----tt-
-S@S-----------tt-#----####-----------------###--###-------tt-----#######--------tt---------tt-----------tt--#######--X---XXXXXXXXXXXXXXXXXXXXXX-XXXXXXXXXXX
-M-#######-----tt#########----------g-g----####--####------tt-g----g-g-tt-g-----------------tt-g----------------------X---XXXXXXXXXXXXXXXXXXXXXX-XXXXXXXXXXX
XXXXXXXXXXXXXXXXXXXXXXXXXXXXXXXXXXXXXXXXXXXXXXXXXXXXXXXXXXXXXXXXXXXXXXXXXXXXXXXXXXXXXXXXXXXXXXXXXXXXXXXXXXX-------------------------------------------------
XXXXXXXXXXXXXXXXXXXXXXXXXXXXXXXXXXXXXXXXXXXXXXXXXXXXXXXXXXXXXXXXXXXXXXXXXXXXXXXXXXXXXXXXXXXXXXXXXXXXXXXXXXX--------g-g--------------------------------------
