---------------------------------------------------------------------------------------------------------------------------------------------------------------------------------
---------------------------------------------------------------------------------------------------------------------------------------------------------------------------------
---------------------------------------------------------------------------------------------------------------------------------------------------------------------------------
---------------------------------------------------------------------------------------------------------------------------------------------------------------------------------
--------------SSSSS--------------------------------------------SSS!-----------SSSSS---SSS!---------------------------------------------------------------------------------------
--------------------------------------------------------------------------------------------------------------------------1------------------------------------------------------
------------------------------------------------------------------------------------------------------SS!S------------------------------------##-SU--S@S!S-----------------------
---------------------------------g-----------------------------------------------------------------------------------------------------------###----------------tt---------------
-------------------------------SSSSSSSS---------------------------C----------------------C------tt-#------------------------------XTT-------####----------------tt---------------
----------------####---1------------------------------------------###-----------###########-----tt##--------------g-g-tt#######----tt------#####------g---------tt-g-------------
---------------#####----------g---------S@S!S--------------S@S!S--###-----tt---#####XXXXXXXXXXXXXXXXXXXXXXXXXXXXXXXXXXXXXXXXXXXXXXXXXXXXXXXXXXXX-XXXXXXXXXXXXXXXXXXXXXXXXXXXXXX--
-------tt-----######-------------------------------tt-------------###-----tt--######XXXXXXXXXXXXXXXXXXXXXXXXXXXXXXXXXXXXXXXXXXXXXXXXXXXXXXXXXXXX-XXXXXXXXXXXXXXXXXXXXXXXXXXXXXX--
-------tt-----######--------S@S--------------------tt-----t-------###-----tt--#######--------------------------------------------------------------------------------------------
-M-----tt-g----g-g-tt#######------g-g-tt-g---------tt-g---t-g--------------------------------------------------------------------------------------------------------------------
XXXXXXXXXXXXXXXXXXXXXXXXXXXXXXXXXXXXXXXXXXXXXXXXXXXXXXXXXXXXXXXXXXXXXXXXXXXX-----------------------------------------------------------------------------------------------------
XXXXXXXXXXXXXXXXXXXXXXXXXXXXXXXXXXXXXXXXXXXXXXXXXXXXXXXXXXXXXXXXXXXXXXXXXXXX-----------------------------------------------------------------------------------------------------
