-------------------------------------------------------------------------------------------------------------------------------------------------------------------------------------------
-------------------------------------------------------------------------------------------------------------------------------------------------------------------------------------------
-------------------------------------------------------------------------------------------------------------------------------------------------------------------------------------------
-------------------------------------------------------------------------------------------------------------------------------------------------------------------------------------------
-------------------------------------------------------------------------------------------------------------------------------------------------------------------------------SSSSS---SSS!
-------------------------------------------------------------------------------------------------------------------------------------------------------------------------------------------
--------------------SSS!-----------------------------------------------------------SSS!----------------------------------SSS!--------------------------------------------------------------
-------------------------------------------------------------------------------------------------------------------------------------------------------------------------------------------
------------------------------------------------------------------------------------------------------------------------------------------------------------------------------------------C
---------------------------------------------------------------------------------------------------------------------------------------------------------------------------------#####-----
-----SS------#--#------C-----------------tt-----!---------#---------SS------#--#------C-------!---#------#------------------C-----SS!S---!-----SS------#--#-------------tt------######-----
------------##--##---------------tt------tt---------------##---------------##--##-----------------##-----##-------------------------------------------##--##------------tt-----#######-----
-----------###--###--------------tt------tt---------------###--tt---------###--###----------------###----###--tt-XTT---------------------------------###--###-----------tt-----#######-----
-M-g-g----####--####----g-g------tt-g----tt-----------gg--####-tt-g-g----####--####----g-g----k---####---####-tt--tt-------------------------g-g----####--####----------tt-----------------
XXXXXXXXXXXXXXXXXXXXXXXXXXXXXXXXXXXXXXXXXXXXXXXXXXXXXXXXX-XXXXXXXXXXXXXXXXXXXXXXXXXXXXXXXXXXXXXXXXXXXXXX-XXXXXXXXXXXXXXXX---XXXXXXXXXXXXXXXXXXXXXXXXXXXXXXXXXXXXXXXXXXXXXXXXXXXXXXXXXX-----
XXXXXXXXXXXXXXXXXXXXXXXXXXXXXXXXXXXXXXXXXXXXXXXXXXXXXXXXX-XXXXXXXXXXXXXXXXXXXXXXXXXXXXXXXXXXXXXXXXXXXXXX-XXXXXXXXXXXXXXXX---XXXXXXXXXXXXXXXXXXXXXXXXXXXXXXXXXXXXXXXXXXXXXXXXXXXXXXXXXX-----
