---------------------------------------------------------------------------------------------------------------------SSS!------------------------------------------------
-------------------------------------------------------------------------------------------------------------------------------------------------------------------------
-------------------------------------------------------------------------------------------------------------------------------------------------------------------------
-------------------------------------------------------------------------------------------------------------------------------------------------------------------------
------------------------------------------------------------------------------------------------------------------------C------------------------------------------------
--------------------------------------------------------------------------------------------------------------------#####------1-----------------------------------------
-------------------------------------------------------------------------------------------------------------------######------------------SSSSS-------------------------
-----------------------------------------------------------------------------g------------------------------------#######------------------------------------------------
---------------------------------------------------------------------------SSSSSSSS---SSS!------------------------#######---------------------------------SSSSS---SSS!---
--------------------------------------------------------------------------------------------------------------------------------#####------------------------------------
-----------SS!S-----##-SU---#---------------------------##--#-------------g--------------------------------------!-------------######------------------------------------
-------------------###------##-------------------------###--##------------------------------------tt---------------------tt---#######--------------------#---------------
-----tt-#---------####------###-----tt------XTT-------####--###-----tt--S@S--------------C--------tt---XTT---------------tt---#######-------------------##-----------C---
-M---tt##--------#####------####----tt-------tt------#####--####----tt--------------#######-------tt-g--tt---------------tt-g-#######------------------#####-------------
XXXXXXXXXXXXXXXXXXXXXX-XXXX-XXXXXXXXXXXXXXXXXXXXXXXXXXXXXX--XXXXXXXXXXXXXXXXXXXXX---XXXXXXXXXXXXXXXXXXXXXXXXXXXXXXXXXXXXXXXXXXXXXXXXXXXXXXXXXX---XXXXXXXXXXX-XXXXXXXXXX--
XXXXXXXXXXXXXXXXXXXXXX-XXXX-XXXXXXXXXXXXXXXXXXXXXXXXXXXXXX--XXXXXXXXXXXXXXXXXXXXX---XXXXXXXXXXXXXXXXXXXXXXXXXXXXXXXXXXXXXXXXXXXXXXXXXXXXXXXXXX---XXXXXXXXXXX-XXXXXXXXXX--
