-----------------------------------------------------------------------------------------------------------------------------------------------------------------------------
-----------------------------------------------------------------------------------------------------------------------------------------------------------------------------
-----------------------------------------------------------------------------------------------------------------------------------------------------------------------------
-----------------------------------------------------------------------------------------------------------------------------------------------------------------------------
-----------------------------------------------------------------------------------------------------------------------------------------------------------------------------
-----------------------------------------------------------------------------------------------------------------------------------------------------------------------------
----------------------------------------------------------------------------------------------------------SSSS---------------------------------------------------------------
-----------------------------------------------------------------------------------------------------------------------------------------------------------------------------
------##---------------------------SSSSSSSSS---SSS!-----SSSSS---S----tt------------------------------------------------------------------------------------------------------
-----###-------------------------------------------------------------tt------------------------------------------------------------------------------------------------------
----####------tt---------------SS!S----------------------------------tt---------------SU--------------tt----------------tt-----SS!SS@S!S-----------SU-----tt-----------------
--------------tt----------------------------tt--------------------------------------------------------tt----------------tt--------------------------------tt-----------------
--------------tt---------tt-#---------------tt----C--------------------------tt-#---------XTT---------tt----------------tt--------------------------------tt----------XTT----
-M------------tt----gg---tt##---------------tt-g-------------g-g-tt----------tt##--gg------tt----#######-----------#######----------g--------g-g-tt-------tt-----------tt----
XXXX---XXXXXXXXXXXXXXXXXXXXXXXXXXXXXXXXXXXXXXXXXXXXXXXXXXXXXXXXXXXXX---XXXXXXXXXXXXXXXXXXXXXXXXXXXXXXXXXXXXX---XXXXXXXXXXXXXXXXXXXXXXXXXXXXXXXXXXXXXXXXXXXXXXXX---XXXXXXXXXXX
XXXX---XXXXXXXXXXXXXXXXXXXXXXXXXXXXXXXXXXXXXXXXXXXXXXXXXXXXXXXXXXXXX---XXXXXXXXXXXXXXXXXXXXXXXXXXXXXXXXXXXXX---XXXXXXXXXXXXXXXXXXXXXXXXXXXXXXXXXXXXXXXXXXXXXXXX---XXXXXXXXXXX
