-----------------------------------------------------------------------------------------------------------------------------------------------------------
-----------------------------------------------------------------------------------------------------------------------------------------------------------
-----------------------------------------------------------------------------------------------------------------------------------------------------------
-----------------------------------------------------------------------------------------------------------------------------------------------------------
------------------------------------------------SSS!--------------------------------------------------SSSSS------------------------------------------------
-----------------------------------------------------------------------------------------------------------------------------------------------------------
------------------------------------------------------------SSS!--------------------------------------------------------------------------------##---------
-----------------------------------------------------------------------------------------------------------------------------------------------###---------
---------------------------------------------------C----------------------------tt------------------------------------------------------------####----SSS!-
----------------------###----------------------#####----------------------------tt-------------------#####-----------------------------------#####---------
-----!---#-------##---###----------------tt---######-----------C-----SU---------tt-------tt---------######-------tt---------------SU--------######---------
---------##-----###---###----------------tt--#######------tt-----------------------------tt--------#######-------tt-----------------------t#######---------
---------###---####---###-XTT------------tt--#######------tt-----------------------------tt----tt-########-------tt--------XTT------------t#######-------C-
-M---k---####--------------tt----------------#######------tt----g-g--------gg------------tt----tt#########------g-g-tt--gg--tt------------tt-g-------------
XXXXXXXXXXXXXXXXXXXXXXXXX-XXXXXXXXXXXXXXXXX--XXXXXXXXXXXXXXXXXXXXXXXXXXXXXXXXXX---XXXXXXXXXXXXXXXXXXXXXXXXXXXXXXXXXXXXXXXXXXXXXXXXXXXXXXXXXXXXXXXXXXXXXXX--
XXXXXXXXXXXXXXXXXXXXXXXXX-XXXXXXXXXXXXXXXXX--XXXXXXXXXXXXXXXXXXXXXXXXXXXXXXXXXX---XXXXXXXXXXXXXXXXXXXXXXXXXXXXXXXXXXXXXXXXXXXXXXXXXXXXXXXXXXXXXXXXXXXXXXX--
