------------------------------------------------------------------------------------------------------------------------------------------------------------
------------------------------------------------------------------------------------------------------------------------------------------------------------
----------------------------------------------------------------------------------------------------------------SSSSS---------------------------------------
------------------------------------------------------------------------------------------------------------------------------------------------------------
------------------------------------------------------------------------------------------------------------------------------------------------------------
------------------------------------------------------------------------------------------------------------------------------------------------------------
------------------------------------------------------------------------------------------------------------------------------------------------------------
--------------------------------------------g--------------g---------------------------------------------------#####--------------------------g-------------
------------------------------------------SSSSSSSS-------SSSSSSSS---SSS!--------------------------------------######------------------------SSSSSSSS---SSS!-
-------------------------------------------------------------------------------------------------------------#######----------------------------------------
------!-----SS----#-------!-----#--#-----g--------------g-------------------##---!-----#--#-----S@S!S--------#######------SS------#--------g----------------
------------------##-----------##--##--------------------------------------###--------##--##---------------tt--------------------##-------------------------
------------------###---------###--###-S@S------------S@S-----------------####-------###--###--------------tt-------------------###------S@S--------------C-
-M--------g-g-----####----k--####--####--#######-----------------g-g-tt--#####---k--####--####---g---------tt-g---------g-g----####--####-------------g-g-tt
XXXXXXXXXXXXXXXXXXXXXXXXXXXXXXXXXXXXXXXXXXXXXXXXXXXXXXXXXXXXXXXXXXXXXXXXXXXXXX-XXXXXXXXXXXXXXXXXXXXXXXXXXXXXXXXXX---XXXXXXXXXXXXXXXXXXXXXXXXXXXXXXXXXXXXXXXX
XXXXXXXXXXXXXXXXXXXXXXXXXXXXXXXXXXXXXXXXXXXXXXXXXXXXXXXXXXXXXXXXXXXXXXXXXXXXXX-XXXXXXXXXXXXXXXXXXXXXXXXXXXXXXXXXX---XXXXXXXXXXXXXXXXXXXXXXXXXXXXXXXXXXXXXXXX
