-------------------------------------------------------------------------------------------------------------------------------------------------------------------------------------------
-------------------------------------------------------------------------------------------------------------------------------------------------------------------------------------------
-------------------------------------------------------------------------------------------------------------------------------------------------------------------------------------------
-------------------------------------------------------------------------------------------------------------------------------------------------------------------------------------------
----------------------------------------------------------------------------------------------------------tt-------------------------------------------------------------------------------
----------------------------------------------------------------------------------------------------------tt-------------------------------------------------------------------------------
----------------------------------------------------------------------------------------------------------tt----SSS!-----------------------------------------------------------------------
-------------------------------------------------------------------------g------------------------------#####------------------------------------------------------------------------------
---------------------------------------------tt------------------------SSSSSSSS------------------------######------------------------------------------------------------------------------
---------------------------------------------tt-------------------------------------------------------#######------------------------------------------------------------------------------
-----SS!S-----##---SS!SS@S!S----!-----#------tt-----------------S@S---g---------------------tt----tt--#######------C----------##----------SS----#------#-----------------------------------
-------------###---------------------##--##-----------------------------------------tt------tt----tt-------------------------###----------------##-----##-----------------------------tt---
------------####--------------------###--###------------------------S@S-------------tt------tt----tt------------------------####-XTT------------###----###-----tt-------------tt-#----tt---
-M---------#####--------g-------k--####--####----g-g----gg-------g--------g-g-tt----tt-g----tt--#######-----g-g------------#####--tt----g-g-----####---####----tt-#######-----tt##----tt-g-
XXXXXXXXXXXXXXXX-XXXXXXXXXXXXXXXXXXXXXXXXXXXXXXXXXXXXXXXXXXXXXXXXXXXXXXXXXXXXXXXXXXXXXXXXXXXXXXXXXXXXXXXXXXXXXXXXX---XXXXXXXXXXX-XXXXXXXXXXXXXXXXXXXXX-XXXXXXXXXXXXXXXXXXXXXXXXXXXXXXXXXXXX
XXXXXXXXXXXXXXXX-XXXXXXXXXXXXXXXXXXXXXXXXXXXXXXXXXXXXXXXXXXXXXXXXXXXXXXXXXXXXXXXXXXXXXXXXXXXXXXXXXXXXXXXXXXXXXXXXX---XXXXXXXXXXX-XXXXXXXXXXXXXXXXXXXXX-XXXXXXXXXXXXXXXXXXXXXXXXXXXXXXXXXXXX
