--------------------------------------------------------------------------------------------------------------------------------------------------------------------------
--------------------------------------------------------------------------------------------------------------------------------------------------------------------------
--------------------------------------------------------------------------------------------------------------------------------------------------------------------------
--------------------------------------------------------------------------------------------------------------------------------------------------------------------------
--------------------------------------------------------------------------------------------------------------------------------------------------------------------------
--------------------------------------------------------------------------------------------------------------------------------------------------------------------------
--------------------------------------------------------------------------------------------------------------------------SSS!-------------------------SSSSS---SSS!-------
--------------------------------------------------------------------------------------------------------------------------------------------------------------------------
--------------------------SSSSS-----------------------------------------------------------------------------------------------------------SSSS---SSS!---------------------
-----------------------------------------1---------------1---------1----------------1-------------------------------------------------------------------------------------
-----!-----#--#-------------------tt-------------tt-----------S@-------------tt------------------------SS----#---------------C---S----tt--------------------------C-------
----------##--##------------------tt-------------tt--------------------------tt-----------------tt-----------##-----------------------tt----------------------------------
---------###--###-----tt-#--------tt-------------tt--------------------------tt-----------------tt-----------###---XTT----------------tt------------C---------------------
-M---k--####--####----tt##--------------g-g-tt---tt-----g-g-tt-g------------------#######-------tt-g-g-g-----####---tt------g-g----------------#######----------------#---
XXXXXXXXXXXXXXXXXXXXXXXXXXXXXXXXXXXX-XXXXXXXXXXXXXXXXXXXXXXXXXXXXXXXXXXXXXXXXXX---XXXXXXXXXXXXXXXXXXXXXXXXXXXXXXXXXXXXXXXXXXXXXXXXXXXXXXXXXXXXXXXXXXXXXXXX---XXXXXXXXXXXXX
XXXXXXXXXXXXXXXXXXXXXXXXXXXXXXXXXXXX-XXXXXXXXXXXXXXXXXXXXXXXXXXXXXXXXXXXXXXXXXX---XXXXXXXXXXXXXXXXXXXXXXXXXXXXXXXXXXXXXXXXXXXXXXXXXXXXXXXXXXXXXXXXXXXXXXXX---XXXXXXXXXXXXX
