------------------------------------------------------------------------------------------------------------------------------------------------------------------------------
------------------------------------------------------------------------------------------------------------------------------------------------------------------------------
------------------------------------------------------------------------------------------------------------------------------------------------------------------------------
-----------------------------------------------g------------------------------------------------------------------------------------------------------------------------------
---------------------------------------------SSSSSSSS----------------------SSS!-----------------------------------------------------------------------------------------------
------------------------------------------------------------------------------------------------------------------------------------------------------------------------------
---------------------------------SSS!-------g---------------------------------------------------------------------------------------------------------------------------------
------------------------------------------------------------------------------------------------------------------------------------------------------------------------------
------------------------------------------S@S---------------------------------C------------------------SSS!-------------------------------------------------------------------
-----------------------------------------------###------------------------#####---------------------------------------1-------------------------------------------------------
------------------------------------C---------####------SU----------tt---######-------SS------#--#-------------tt-------------SU----------------------------------------------
---------------------------------------------#####------------------tt--#######--------------##--##------------tt-------------------------------------tt-----------------tt---
---XTT---------------------------------------#####--tt-#------------tt--#######-------------###--###------C----tt--------------------------XTT--------tt-----------------tt---
-M--tt------g-g---------gg-----------g-g------------tt##-----------------g-g-tt--gg-g-g----####--####---------------#######----------g-g-tt-tt--------tt-g-#######-------tt-g-
XXXXXXXXXXXXXXXXXXXXXXXXXXXX---XXXXXXXXXXXXXXXXXXXXXXXXXXXXXXXXXXXXXXXXXXXXXXXXXXXXXXXXXXXXXXXXXXXXXXXXXXXXXXXXXX---XXXXXXXXXXXXXXXXXXXXXXXXXXXXXXXXXXXXXXXXXXXXXXXXXXXXXXXXXX
XXXXXXXXXXXXXXXXXXXXXXXXXXXX---XXXXXXXXXXXXXXXXXXXXXXXXXXXXXXXXXXXXXXXXXXXXXXXXXXXXXXXXXXXXXXXXXXXXXXXXXXXXXXXXXX---XXXXXXXXXXXXXXXXXXXXXXXXXXXXXXXXXXXXXXXXXXXXXXXXXXXXXXXXXX
