-----------------------------------------------------------------------------------------------------------------------------------------------------------------
-----------------------------------------------------------------------------------------------------------------------------------------------------------------
-----------------------------------------------------------------------------------------------------------------------------------------------------------------
-----------------------------------------------------------------------------------------------------------------------------------------------------------------
-------------------------------------------------------------------------------------SSSSS---SSS!----------------------------------------------------------------
--------------------------------------------------------------------------------------------------------------1-------------------1------------------------------
-------------------------------------------------------------------------------------------------------tt--------------------------------------------------------
---------------------------------1---------------------------------------------------------------------tt--------------------------------------------------------
----------------SSS!----------------------------------------------------------------------------C------tt---------------#--------------------------------##------
---------------------------------------------------------------------------------------#####----------------------------##------------------------------###------
---------------------------##----------------------!---#------#-----------------------######---XXXXXXXXX----------------###-----tt---------------------####------
-------tt-----------------###--------------------------##-----##---------------------#######---XXXXXXXXX----------g-g---####----tt------------g-g-tt--#####------
-------tt----------C-----####-------------XTT----------###----###-----tt-------------#######------------X---XXXXXXXXXXX-XXXXXXXXXXXX---XXXXXXXXXXXXXXXXXXXX-XXXXX
-M-----tt-g-#######-----#####---gg---g-g---tt------k---####---####----tt--------gg----g-g-tt--g-g-------X---XXXXXXXXXXX-XXXXXXXXXXXX---XXXXXXXXXXXXXXXXXXXX-XXXXX
XXXXXXXXXXXXXXXXXXXXXXXXXXXXX-XXXXXXXXXXXXXXXXXXXXXXXXXXXXXXX-XXXXXXXXXXXXXXXXXXXXXXXXXXXXXXXXXXXXXXXXXXXXXX-----------------------------------------------------
XXXXXXXXXXXXXXXXXXXXXXXXXXXXX-XXXXXXXXXXXXXXXXXXXXXXXXXXXXXXX-XXXXXXXXXXXXXXXXXXXXXXXXXXXXXXXXXXXXXXXXXXXXXX-----------------------------------------------------
