----------------------------------------------------------------------------------------------------------------------------------------------------------------------------------------------------------
----------------------------------------------------------------------------------------------------------------------------------------------------------------------------------------------------------
----------------------------------------------------------------------------------------------------------------------------------------------------------------------------------------------------------
----------------------------------------------------------------------------------------------------------------------------------------------------------------------------------------------------------
----------------------------------------------------------------------------------------------------------------------------------------------------------------------------------------------------------
----------------------------------------------------------------------------------------------------------------------------------------------------------------------------------------------------------
----------------------------------------------------------------------------------------------------------------------------------------------------------------------------------SSSSS-------------------
----------------------------------------------------------------------------------------------------------------------------------------------------------------------------------------------------------
--------------------------------------------tt---------------------------------------tt-----------------------------------------------------------------------------tt------------------------------------
--------------------------------------------tt---------------------------------------tt-----------------------------------------------------------------------------tt------------------------------------
-----SS!S-----S@S!S---------------#S@S!S----tt------------!---------------SS----#----tt-------S@S!S-----tt---------tt---tt--S@S!S------------tt--SU-------##--------tt--------------------------------tt--
---------------------------------##---------------------------------------------##----------------------tt---------tt---tt-------------------tt----------###-----tt-----------------------------------tt--
--------------------------------###---------------------------------------------###---------------------tt---------tt---tt---------XTT-------tt---------####-----tt----------XTT------------XTT-------tt--
-M-------------g-------------g-g-tt-g---------------gg--------#######---g-g-----####-----------g--------tt-----g-g-tt---tt---g------tt-------tt--------#####-----tt-g---g-g---tt-------------tt-------tt--
XXXXXXXXXXXXXXXXXXXXXXXXXXXXXXXXXXXXXXXXXXX---XXXXXXXXXXXXXXXXXXXXXXXXXXXXXXXXXXXXXXXXX---XXXXXXXXXXXXXXXXXXXXXXXXXXXXXXXXXXXXXXXXXXXXXXXXXXXXXXXXXXXXXXXXXX-XXXXXXXXXXXXXXXXXXXXXXXX---XXXXXXXXXXXXXXXXXX
XXXXXXXXXXXXXXXXXXXXXXXXXXXXXXXXXXXXXXXXXXX---XXXXXXXXXXXXXXXXXXXXXXXXXXXXXXXXXXXXXXXXX---XXXXXXXXXXXXXXXXXXXXXXXXXXXXXXXXXXXXXXXXXXXXXXXXXXXXXXXXXXXXXXXXXX-XXXXXXXXXXXXXXXXXXXXXXXX---XXXXXXXXXXXXXXXXXX
