----------------------------------------------------------------------------------------------------------------------------------------------------------------------------------------------------------
----------------------------------------------------------------------------------------------------------------------------------------------------------------------------------------------------------
----------------------------------------------------------------------------------------------------------------------------------------------------------------------------------------------------------
----------------------------------------------------------------------------------------------------------------------------------------------------------------------------------------------------------
----------------------------------------------------------------------------------------------------------------------------------------------------------------------------------------------------------
----------------------------------------------------------------------------------------------------------------------------------------------------------------------------------------------------------
----------------------------------------------------------------------------------------------------------------------------------------------------------------------------------------------------------
-------------------------------------------------------------------------------------------------------------------------------------------------------------g--------------------------------------------
-------------------------------------------------------------------------------------------------tt--------------------------------------------------------SSSSSSSS---SSS!--------------------------------
-------------------------------------------------------------------------------------------------tt-------------------------------------------------------------------------------------------------------
--------------SS----#--------!-----------#----------SU--------------!------------------SS!S------tt----------S@S!S---#-------------!----------------------g---------------------SS----#--------tt---------
-------tt-----------##-------------------##-----------------tt-------------------------------------------------------##---------------------------------------------------------------##-------tt---------
-------tt-----------###----------XTT-----###-----tt---------tt----------XTT------tt-#--------------------tt-#--------###-----tt----------tt-#-----------S@S--------------C------------###------tt---------
-M-----tt-g-g-g-----####----------tt-----####----tt---------tt-g---------tt------tt##--------gg---g-g----tt##-g------####----tt----------tt#########----------------#######---g-g-----####-----tt---------
XXXXXXXXXXXXXXXXXXXXXXXXXXXXXXXXXXXXXXXX-XXXXXXXXXXXXXXXXXXXXXXXXXXXXXXXXXXXXXXXXXXXXXXXXXXXXXXXXXXXXXXXXXXXXXXXXXXX-XXXXXXXXXXXXXXXXXXXXXXXXXXXXXXXXXXXXXXXXXXXX---XXXXXXXXXXXXXXXXXXXXXXXXXXXXXXXX---XXX
XXXXXXXXXXXXXXXXXXXXXXXXXXXXXXXXXXXXXXXX-XXXXXXXXXXXXXXXXXXXXXXXXXXXXXXXXXXXXXXXXXXXXXXXXXXXXXXXXXXXXXXXXXXXXXXXXXXX-XXXXXXXXXXXXXXXXXXXXXXXXXXXXXXXXXXXXXXXXXXXX---XXXXXXXXXXXXXXXXXXXXXXXXXXXXXXXX---XXX
