-----------------------------------------------------------------------------------------------------------------------------------------------
-----------------------------------------------------------------------------------------------------------------------------------------------
-----------------------------------------------------------------------------------------------------------------------------------------------
-----------------------------------------------------------------------------------------------------------------------------------------------
-------------------------------------SSSSS-----------------------------------------------------------SSS!--------------SSS!--------------------
-----------------------------------------------------------------------------------------------------------------------------------------------
-----------------------------------------------------------------------------------------------------------------------------------------------
-----------------------------------------------------------------------------------------------------------------------------------------------
--------SSS!-----SSS-----SSS!---------------------------SSSSS---SSS!------##----------------------------C-----------------C--------------------
---------------------------------------#####-----------------------------###------------------------------------------#####--------------------
---S@----------------------------tt---######----------------------------####---S@S!S----------tt---#-----------------######--------------------
---------------------------------tt--#######--------------------------------------------------tt--##----------------#######--------------------
-----------C----------------C----tt--#######-----------------------C--------------------------tt--##----------------#######--------------------
-M--g-----------------gg--------------g-g-tt-----gg-----------#######-----g-g---g------------------g----------------------------gg-------------
XXXXXXXXXXXXXXXXXXXXXXXXXXXXXXXXXXXXXXXXXXXX---XXXXXXXXXXXXXXXXXXXXXXXXXXXXXXXXXXXXXXXXXXXXXXXXXXXXXXXXXXXXXXXXXXXXXXXXXXXX---XXXXXXXXXXXXXXX--
XXXXXXXXXXXXXXXXXXXXXXXXXXXXXXXXXXXXXXXXXXXX---XXXXXXXXXXXXXXXXXXXXXXXXXXXXXXXXXXXXXXXXXXXXXXXXXXXXXXXXXXXXXXXXXXXXXXXXXXXX---XXXXXXXXXXXXXXX--
