--------------------------------------------------------------------------------------------------------------------------------------------------------------
--------------------------------------------------------------------------------------------------------------------------------------------------------------
-----------------------------------------------------------------------------------------------------------------------SSSSS---SSS!--SSSSS---SSS!-------------
--------------------------------------------------------------------------------------------------------------------------------------------------------------
-----------------------------------------------------------------------------------------------------------------------------------------------------tt-------
-----------------------------------------------------------------------------------------------------------------------------------------------------tt-------
-----------------------------------------------------------SSSSS----SSS!----------------------------------------------------------C-------------C----tt-------
----------------------------------------------------------------------------------------------------------------------#####-----------------g-g-tt---tt----gg-
----------------------------------------SSS!-------------------------------------------------------------------SSSSS-######------XXXXXXXXXXXXXXXXXXXXXXXXXXXXX
-------------1-------------------------------------------1----------------------------------------------------------#######------XXXXXXXXXXXXXXXXXXXXXXXXXXXXX
--------##----------------------!---#-------------tt-------------------C-------------tt-----------S@S!S-------------#######-----------------------------------
-------###---------------tt---------#-------------tt---------------------------------tt-----------------------------------------------------------------------
------####---------------tt---------#------C------tt---------------------------tt----tt-----------------------------------------------------------------------
-M---#####-#######-------tt-g---k---####----------------g-g-tt--g-g------------tt#########-----gg--g----------#######-----g-g-------#-------------------------
XXXXXXXXXX-XXXXXXXXXXXXXXXXXXXXXXXXXXXXXXXXXXXXXXXXX-XXXXXXXXXXXXXXXXX---XXXXXXXXXXXXXXXXXXXXXXXXXXXXXXXXXXXXXXXXXXXXXXXXXXXXXXXXXXXXXXX----------------------
XXXXXXXXXX-XXXXXXXXXXXXXXXXXXXXXXXXXXXXXXXXXXXXXXXXX-XXXXXXXXXXXXXXXXX---XXXXXXXXXXXXXXXXXXXXXXXXXXXXXXXXXXXXXXXXXXXXXXXXXXXXXXXXXXXXXXX----------------------
