----------------------------------------------------------------------------------
-----------tt---------------------------------------------------------------------
-----------tt---------------SSSSS---SSS!------------------------------------------
-----------tt-g-------------------------------------------------------------------
-------XXXXXXXXXXXXXXXXXXX--------------------------------------------------------
-------XXXXXXXXXXXXXXXXXXX--------------------------------------------------------
--------------------#######------------C-------------------SSS!-------------------
-------------------------------------#####----------------------------------------
------------------------XXXXXXXXXX--######----------------------------------------
------------------------XXXXXXXXXX--######----------------------------------------
-----SS!S---------SS!S---tt--------#######------SS!S----------C---SU-------tt-----
-------------------------tt------tt----------------------------------------tt-----
---------XTT-------------tt------tt-----------------XTT--------------------tt-----
-M--------tt-------------tt------tt-g----------------tt------g-g------------------
XXXXXXXXXXXXXXXXXXXXXXXXXXXXXXXXXXXXXXX---XXXXXXXXXXXXXXXXXXXXXXXXXXXXXXXXXXXXXX--
XXXXXXXXXXXXXXXXXXXXXXXXXXXXXXXXXXXXXXX---XXXXXXXXXXXXXXXXXXXXXXXXXXXXXXXXXXXXXX--
