-------------------------------------------------------------------------------------------------------------------------------
-------------------------------------------------------------------------------------------------------------------------------
------------------------------------------------------------------C------SSSSS-------------------------------------------------
------------------------------------------------#######------------------------------------1-----------------------------------
------------------------------------------------XXXXXXXXXXXXXXXXXXXX----------------tt-----------------------------------------
------------------------------------------------XXXXXXXXXXXXXXXXXXXX----------------tt-----------------------------------------
--------------------------------------------------------------#######---------------tt-----------------------------------------
------g-------------------------------------------------------------------------------------#####------------------------------
----SSSSSSSS---SSS!-----------------------------------------------XXXXXXXXXX--XXXXXXXX-----######-------------------------SSS!-
------------------------------------------------------------------XXXXXXXXXX--XXXXXXXX----#######------------------------------
---g----------------------tt---------tt---tt---#-------------SU--S@S!S-------##----------S#######---------##---SS----##--------
--------------------------tt---------tt---tt---##---------------------------###-----tt-------------------###--------###--------
-S@S--------------C-------tt---------tt---tt---###--tt---tt-#--------------####-----tt------------------####-------####------C-
-M-----------#######------tt-----g-g-tt---tt---####-tt---tt##-----g-------#####-----tt-g---------------#####-------------------
XXXXXXXXXXXXXXXXXXXXXXXXXXXXXXXXXXXXXXXXXXXXXX-XXXXXXXXXXXXXXXXXXXXXXXXXXXXXXXX-XXXXXXXXXXXXXX---XXXXXXXXXXX-XXXXXXXXXXXXXXXX--
XXXXXXXXXXXXXXXXXXXXXXXXXXXXXXXXXXXXXXXXXXXXXX-XXXXXXXXXXXXXXXXXXXXXXXXXXXXXXXX-XXXXXXXXXXXXXX---XXXXXXXXXXX-XXXXXXXXXXXXXXXX--
