----------------------------------------------------------------------------------------------------------------------------------------------------------------------------------------
----------------------------------------------------------------------------------------------------------------------------------------------------------------------------------------
----------------------------------------------------------------------------------------------------------------------------------------------------------------------------------------
----------------------------------------------------------------------------------------------------------------------------------------------------------------------------------------
----------------------------------------------------------------------------------------------------------------------------------------------------------------------------------------
----------------------------------------------------------------------------------------------------------------------------------------------------------------------------------------
--------------------------------------------------------------SSS!-----------------------------------------------------------------SSS!-------------------------------------------------
----------------------------------------------------------------------------------------------------------------------------------------------------------------------------------------
--------tt-----------------------------SSSSS--------------------------------------------------------------------------------------------------------------------------------------------
--------tt--------------------------------------------------------------------------------------------------------------------------------------------------------------#####------1----
---S----tt-----------SS------#--#-----------------SS----#--------C-----SS----#--------!-----!-----#--#-----S@S!S-----tt---#-----------C--------##-SU-----tt----------#-######-----------
----------------------------##--##----------------------##-------------------##------------------##--##--------------tt---##------------------###--------tt---------#########-----------
---------------------------###--###---------------------###------------------###----------------###--###-------------tt---###--tt------------####--------tt----tt--##########-----------
-M-------g-g-------g-g----####--####--#######---g-g-----####----g-g--g-g-----####-----------k--####--####---g--------tt---####-tt-----------#####--------tt----tt##---------------g-g-tt
XXXXXXXXXXXXXXXXXXXXXXXXXXXXXXXXXXXXXXXXXXXXXXXXXXXXXXXXXXXXXXXXXXXXXXXXXXXXXXXXXXXXXXXXXXXXXXXXXXXXXXXXXXXXXXXXXXXXXXXXX-XXXXXXXXX---XXXXXXXXXXX-XXXXXXXXXXXXXXXXXXXXXXXXXXX--XXXXXXXXX
XXXXXXXXXXXXXXXXXXXXXXXXXXXXXXXXXXXXXXXXXXXXXXXXXXXXXXXXXXXXXXXXXXXXXXXXXXXXXXXXXXXXXXXXXXXXXXXXXXXXXXXXXXXXXXXXXXXXXXXXX-XXXXXXXXX---XXXXXXXXXXX-XXXXXXXXXXXXXXXXXXXXXXXXXXX--XXXXXXXXX
