------------------------------------------------------------------------------------------------------------------------------------------------------------------------
------------------------------------------------------------------------------------------------------------------------------------------------------------------------
------------------------------------------------------------------------------------------------------------------------------------------------------------------------
------------------------------------------------------------------------------------------------------------------------------------------------------------------------
------------------------------------------------------------------------------------------------------------------------------------------------------------------------
------------------------------------------------------------------------------------------------------------------------------------------------------------------------
----------------------------------------------------------------------------------------------------------------------------------------------------SSS!----------------
------------------------------------------------------------------------------------------------------------------------------------------------------------------------
------------------------------------------tt----------------------tt------##-----------------------------SSS!-----------------------------------------------------------
-------#####------------------------------tt----------------------tt-----###--------------------1-----------------------------------------------------------------------
------######--------------------#---------tt-------tt---------tt--tt----####-----SS!S---!----------------------------SU----------SS----#--------!------C---S@S!S----SS!S
-----#######--------------------##-----------------tt---------tt-----------------------------------------------------------------------##-------------------------------
-----#######---t-#--------------###--tt------------tt---------tt--------------------------------------------C----tt-#------tt-#--------###------------------------------
-M----g-g-tt--tt##--------------####-tt------------tt-----g-g-tt----------g-g------------------g-g-tt#######-----tt##------tt##g-g-----####-----------g-g---g-----------
XXXXXXXXXXXXXXXXXXXXXXXX---XXXX-XXXXXXXXX---XXXXXXXXXXXXXXXXXXXXX---XXXXXXXXXXXXXXXXXXXXXXXXXXXXXXXXXXXXXXXXXXXXXXXXXXXXXXXXXXXXXXXXXXXXXXXXXXXXXXXXXXXXXXXXXXXXXXXXXXXX
XXXXXXXXXXXXXXXXXXXXXXXX---XXXX-XXXXXXXXX---XXXXXXXXXXXXXXXXXXXXX---XXXXXXXXXXXXXXXXXXXXXXXXXXXXXXXXXXXXXXXXXXXXXXXXXXXXXXXXXXXXXXXXXXXXXXXXXXXXXXXXXXXXXXXXXXXXXXXXXXXX
