--------------------------------------------------------------------------------------------------------------------------------------------------------------------------------
--------------------------------------------------------------------------------------------------------------------------------------------------------------------------------
--------------------------------------------------------------------------------------------------------------------------------------------------------------------------------
--------------------------------------------------------------------------------------------------------------------------------------------------------------------------------
--------------------------------------------------------------------------------------------------------------------------------------------------------------------------------
--------------------------------------------------------------------------------------------------------------------------------------------------------------------------------
-----------------------------------------------------------------------------------------------------------------------------SSS!-----------------------------------------------
-----------------g-----------------------------1--------------------------------------------------------------------------------------------------------------------------------
-----##--------SSSSSSSS----##-----------------------------------------------------------------------------SSSSS---SSS!----------------------------------------------------------
----###-------------------###---------------------------------------------------------------------------------------------------------------------------------------------------
---####-------g----------####---S@S!S---#-----------------!---#-------------!---#----------S@S!S-------------------------#------C--------------SS!S----------##-----------------
----------------------------------------##--------------------##----------------##---------------------------------------##---------------------------------###-----tt----------
------------S@S-------------------------###--tt---------------###-----tt-#------###---------------XTT----------------C---###----------XTT------------------####-----tt----------
-M---g-g----gg----g-g-tt---------g------####-tt-----------k---####----tt##--k---####--------g------tt----#######-----k---####----g-g---tt------------gg---#####-----tt-g---g-g--
XXXXXXXXXXXXXXXXXXXXXXXXX---XXXXXXXXXXX-XXXXXXXXX---XXXXXXXXXXXXXXXXXXXXXXXXXXXXXXXXXXXXXXXXXXXXXXXXXXXXXXXXXXXXXXXXXXXXXXXXXXXXXXXXXXXXXXXXXXXXXXXXXXXXXXXXXXX-XXXXXXXXXXXXXXXX
XXXXXXXXXXXXXXXXXXXXXXXXX---XXXXXXXXXXX-XXXXXXXXX---XXXXXXXXXXXXXXXXXXXXXXXXXXXXXXXXXXXXXXXXXXXXXXXXXXXXXXXXXXXXXXXXXXXXXXXXXXXXXXXXXXXXXXXXXXXXXXXXXXXXXXXXXXX-XXXXXXXXXXXXXXXX
