----------------------------------------------------tt---------------------------------------------------------------------------------------
--------g-------------------------------------------tt---------------------------------------------------------------------------------------
------SSSSSSSS---SSS!-------------------------------tt------------------------------------------------SSS!-----------------------------------
--------------------------------------------------#####--------------------------------------------------------------------------------------
-----g---------------------tt---------------tt---######--------SSS!--------------------------------------------------------------------------
---------------------------tt---------------tt--#######--------------------------------------------------------------------------------------
---S@S--------------C------ttXTT------------tt--#######-------------S@S!S----SS----#-----------#---------C-------!---#--------tt--SU---------
-----------#####--------------tt---------------------------------------------------##----------##--------------------##-------tt-------------
----------######---XXXXXXXXXXXXXXXXXXXXX-tt-----------------------C----------------###---------###--tt---------------###------tt-------------
---------#######---XXXXXXXXXXXXXXXXXXXXX-tt-----------g-g-----g-g-tt-g-----g-g-----####--------####-tt-----------k---####-----tt--------g-g--
---SU----#######------------------------XXXXX---XXXXXXXXXXXXXXXXXXXXXXXXXXXXXXXXXXXXXXXXXXXXXX-XXXXXXXXX---XXXXXXXXXXXXXXXXXXXXXXXXXXXXXXXXXX
----------------------------------------XXXXX---XXXXXXXXXXXXXXXXXXXXXXXXXXXXXXXXXXXXXXXXXXXXXX-XXXXXXXXX---XXXXXXXXXXXXXXXXXXXXXXXXXXXXXXXXXX
---------------------------------------------------------------------------------------------------------------------------------------------
-M-------------g-g-------#-------------------------------------------------------------------------------------------------------------------
XXXXXXXXXXXXXXXXXXXXXXXXXXXXX----------------------------------------------------------------------------------------------------------------
XXXXXXXXXXXXXXXXXXXXXXXXXXXXX----------------------------------------------------------------------------------------------------------------
