-------------------------------------------------------------------------------------------------------------------------------------------------------------------
-------------------------------------------------------------------------------------------------------------------------------------------------------------------
-------------------------------------------------------------------------------------------------------------------------------------------------------------------
-------------------------------------------------------------------------------------------------------------------------------------------------------------------
-------------------------------------------------------------------------------------------------------------------------------------------------------------------
-------------------------------------------------------------------------------------------------------------------------------------------------------------------
-----------------------------------------------------------------------------------------------------------------------SSS!----------------------------------------
-----------------------------------------------------------------------------------1--------------------------------------------------g----------------------------
-------------##-------------------------------------------------------##------------------------------------------------------------SSSSSSSS---SSS!--SSSSS---------
------------###------------------------------------------------------###-------1-----------------------------------------------------------------------------------
---S@S!S---####--------tt----------SS----#-----SU----!---#----------####--------------------------S@S!S-------------------C--------g--------------------------##---
-----------------------tt----------------##--------------##--------------------------------------------------tt----------------------------------------------###---
-----------------------tt----------------###-------------###----------------------------------tt-#-----------tt---XTT------------S@S--------------C---------####---
-M--g-------------#######--------g-g-----####--------k---####----gg---g-g-----g-g-tt----------tt##-g---------tt-g--tt------g-g-------------#######-----------------
XXXXXXXXXXX---XXXXXXXXXXXXXXXXXXXXXXXXXXXXXXXXXXXXXXXXXXXXXXXXXXXXXXXXXXXXXXXXXXXXXXX---XXXXXXXXXXXXXXXXXXXXXXXXXXXXXXXXXXXXXXXXXXXXXXXXXX-XXXXXXXXXXXXXXXXXXXX----
XXXXXXXXXXX---XXXXXXXXXXXXXXXXXXXXXXXXXXXXXXXXXXXXXXXXXXXXXXXXXXXXXXXXXXXXXXXXXXXXXXX---XXXXXXXXXXXXXXXXXXXXXXXXXXXXXXXXXXXXXXXXXXXXXXXXXX-XXXXXXXXXXXXXXXXXXXX----
