-----------------------------------------------------------------------------------------------------------------------------------------------------------------------------
-----------------------------------------------------------------------------------------------------------------------------------------------------------------------------
----------------------------------------------------------------------------------------------------SSS!-----SSSSS---SSS!----------------------------------------------------
-----------------------------------------------------------------------------------------------------------------------------------------------------------------------------
-----------------------------------------------------------------------------------------------------------------------------------------------------------------------------
-----------------------------------------------------------------------------------------------------------------------------------------------------------------------------
-------------------------------------------------------------------------------------------------------C----------------C----------------------------------------------------
----------------------------------------------------------------------------------------------------------------------#####--------------------------------------------------
-----SSS!----------------------------------------------------------SSS-------------##-----------------XXXXXXXXXX-----######--------------------------------------------------
----------------------------------------------------------------------------------###-----------------XXXXXXXXXX----#######--------------------------------------------------
--------------#------------SS----#--------tt-------##----tt--------------!---SU--####------------S@S!S-------##-----#######------SS------#--#--------!----------tt---!-------
--------------##-----------------##-------tt------###----tt---------------------------------tt--------------###-------------------------##--##------------------tt-----------
--------C-----###-----tt---------###------tt-----####----tt---------------------------------tt-------------####-XTT--------------------###--###-----------------tt-----------
-M-#######----####----tt-g-g-----####-----tt----#####----tt-----g-g-tt-------------g-g------tt-g--g-------#####--tt------------g-g----####--####------------g-g-tt-------#---
XXXXXXXXXXXXX-XXXXXXXXXXXXXXXXXXXXXXXXXXXXXXXXXXXXXXX-XXXXXXXXXXXXXXXXXXXXXXXXXXXXXXXXXXXXXXXXXXXXXXXXXXXXXXXXX-XXXXXXXX---XXXXXXXXXXXXXXXXXXXXXXXXXXXXXXXXXXXXXXXXXXXXXXXXXX
XXXXXXXXXXXXX-XXXXXXXXXXXXXXXXXXXXXXXXXXXXXXXXXXXXXXX-XXXXXXXXXXXXXXXXXXXXXXXXXXXXXXXXXXXXXXXXXXXXXXXXXXXXXXXXX-XXXXXXXX---XXXXXXXXXXXXXXXXXXXXXXXXXXXXXXXXXXXXXXXXXXXXXXXXXX
