----------------------------------------------------------------------------------------------------------------------------------------
----------------------------------------------------------------------------------------------------------------------------------------
----------------------------------------------------------------------------------------------------------------------------------------
----------------------------------------------g-----------------------------------------------------------------------------------------
------------------------------SSSSS---SS----SSSSSSSS---SSS!SSSSS---SSS!------------SSSSS------------------------------------------------
----------------------------------------------------------------------------------------------------------------------------------------
-------------------------------------------g--------------------------------------------------------------------------------------------
---------1------------------------------------------------------------------------------------------------------------------------------
-----------------------------------------S@S--------------C-----------C-SSSSS---SSS------------------------------------SSSSS------------
--------------------------------#####-----------------------------#####--------------#####------1---------------------------------------
-------------------tt-----tt---######---XXXXXXXXXXXXXXXXXXXS--------###-------------######-------------------!--------------SS---!--!---
-------###---------tt-----tt--#######---XXXXXXXXXXXXXXXXXXX---------###------------#######----------------------------------------------
------####---------tt-----tt--#######-------------------------------###------------#######----------------------------------------------
-M---#####---g-g-------------------------------------------------gg----------------------------g-g-tt---------------g-g-ttg-g-----------
XXXXXXXXXX-XXXXXXXXXXXXXXXXX-------------------------------XXXXXXXXXXXXXXXXXXX--XXXXXXXXXX--XXXXXXXXXXXXXXXXXXXXXXXXXXXXXXXXXXXXXXXXXXXX
XXXXXXXXXX-XXXXXXXXXXXXXXXXX-------------------------------XXXXXXXXXXXXXXXXXXX--XXXXXXXXXX--XXXXXXXXXXXXXXXXXXXXXXXXXXXXXXXXXXXXXXXXXXXX
