------------------------------------------------------------------------------------------------------------------------------------------------------------------------------------
------------------------------------------------------------------------------------------------------------------------------------------------------------------------------------
------------------------------------------------------------------------------------------------------------------------------------------------------------------------------------
------------------------------------------------------------------------------------------------------------------------------------------------------------------------------------
--------------------------------------------------------------------------------------SSSSS-----------------------------------------------------------------------------------------
------------------------------------------------------------------------------------------------------------------------------------------------------------------------------------
-------------------------------------------------------------------------------------------------SSSSS------------------------------------------------------------------------------
------------------------------------------------------------------------------------------------------------------------------------------------------------------------------------
----SSSSS---SSS!--------------------------------------------------------------------------------------------------------------------------------------------------------------------
----------------------------------------------------------------------------------------#####---------------------------------------------------------------------------------------
-----------------------#----------tt---#---------!---#------#------------SS!S----------######----------------SS------#--#-------SS------#--#-----------------#----------------------
-----------------tt----##---------tt---##------------##-----##------------------------#######-----------------------##--##-------------##--##----------------##---------------------
---------------C-tt----###--tt----tt---###--tt-------###----###-----tt-------XTT------#######----------------------###--###-----------###--###----------tt-#-###-----tt-------------
-M-#######-------tt-g--####-tt----tt---####-tt---k---####---####----tt--------tt-------g-g-tt-tt------g-g--g-g----####--####--g-g----####--####---------tt##-####----tt-------------
XXXXXXXXXXXXXXXXXXXXXX-XXXXXXXXXXXXXXX-XXXXXXXXXXXXXXXXXXXX-XXXXXXXXXXXXXXXXXXXXXXXXXXXXXXXXXXXXXXXXXXXXXXXXXXXXXXXXXXXXXXXXXXXXXXXXXXXXXXXXXXXXXXXXXXXXXXXX-XXXXXXXXXXXXXXXXXXXXX--
XXXXXXXXXXXXXXXXXXXXXX-XXXXXXXXXXXXXXX-XXXXXXXXXXXXXXXXXXXX-XXXXXXXXXXXXXXXXXXXXXXXXXXXXXXXXXXXXXXXXXXXXXXXXXXXXXXXXXXXXXXXXXXXXXXXXXXXXXXXXXXXXXXXXXXXXXXXX-XXXXXXXXXXXXXXXXXXXXX--
