--------------------------------------------------------------------------------------------------------------------------------------------------------------------------
--------------------------------------------------------------------------------------------------------------------------------------------------------------------------
--------------------------------------------------------------------------------------------------------------------------------------------------------------------------
--------------------------------------------------------------------------------------------------------------------------------------------------------------------------
--------------------------------------------------------------------------------------------------------------------------------------------------------------------------
--------------------------------------------------------------------------------------------------------------------------------------------------------------------------
--------------------------------------------------------------------------------------------------------------------------------------------------------------------------
-------------g------------------------------------------------------------------------------------------------------------------------------------------------------------
-----------SSSSSSSS---SSS-----------------------------------------------------------------------------------------------SSSSSSSSS---SSS-------------SSS-----SSS!-----SSS!-
--------------------------------------------------------------------------------------------------------------------------------------------------------------------------
-----tt---g------------------tt------S@S!S----------------##--#-------------SU-------------------------SS------#--#--------------------S@S!S------------------------------
-----tt----------------------tt-----------------tt-------###--##--------------------tt------------------------##--##------------------------------------------------------
-----tt-S@S------------------tt-----------------tt------####--###--tt---tt-#--------tt---XTT-----------------###--###------------------------------------------C--------C-
-M-------------------g-g-tt#######----g---------tt-g---#####--####-tt---tt##--------tt-g--tt---------g-g----####--####-----------g-g-tt-g--------g-g-tt---tt--------------
XXXXXXXXXXXXXXXXX-XXXXXXXXXXXXXXXXXXXXXXXXXXXXXXXXXXXXXXXXXX--XXXXXXXXXXXXXXXXXXXXXXXXXXXXXXXXXXXXXXXXXXXXXXXXXXXXXXXXXXXXXXXXXXXXXXXXXXXXXXXXXXXXXXXXXXXXXXXXXXXXXXXXXX--
XXXXXXXXXXXXXXXXX-XXXXXXXXXXXXXXXXXXXXXXXXXXXXXXXXXXXXXXXXXX--XXXXXXXXXXXXXXXXXXXXXXXXXXXXXXXXXXXXXXXXXXXXXXXXXXXXXXXXXXXXXXXXXXXXXXXXXXXXXXXXXXXXXXXXXXXXXXXXXXXXXXXXXX--
