-------------------------------------------------------------------------------------------------------------------------------------------------------------------------------------------
-------------------------------------------------------------------------------------------------------------------------------------------------------------------------------------------
-------------------------------------------------------------------------------------------------------------------------------------------------------------------------------------------
-------------------------------------------------------------------------------------------------------------------------------------------------------------------------------------------
-------------------------------------------------------------------------------------------------------------------------------------------------------------------------------------------
-------------------------------------------------------------------------------------------------------------------------------------------------------------------------------------------
----------SSS!-----------------------------------------------------------------------------------------------------------------------------------------------------------------------------
-----g-------------------------------------------------------------------------------------------------------------------------------------------------------------------------------------
---SSSS----------------------SSS!---------------------------------------------SSS!---------------------------------------------------------------------------------------##----------------
------------------------------------------------------------------------------------------------------------------------------------------------------------------------###----------------
--g----------C-------SS!S------------!---S@S!S----SS------#--#-----SU-----------------------#---------SS!SS@S!S----SS!S--SS------#--#--------!--------##-----------tt--####---------S@S!S--
---------------------------------------------------------##--##-----------------------------##----------------------------------##--##---------------###-----------tt----------------------
S@S-----------------------------C-----------------------###--###-----------------C----------###--tt----------------------------###--###-------------####-XTT-------tt-----------tt-#-------
-M----g-g-tt--g-g-----------g-g-tt--------g-----g-g----####--####--------gg-#######---------####-tt--------g-----------g-g----####--####-----------#####--tt-------tt----g-g----tt##-g-----
XXXXXXXXXXXXXXXXXXXXXXXXXXXXXXXXXXXXXXXXXXXXXXXXXXXXXXXXXXXXXXXXXXXXXXXXXXXXXXXXXXXXXXXXXXX-XXXXXXXXXXXXXXXXXXXXXXXXXXXXXXXXXXXXXXXXXXXXXXXXXXXXXXXXXXXX-XXXXXXXXXXXXXXXXXXXXXXXXXXXXXXXXXX
XXXXXXXXXXXXXXXXXXXXXXXXXXXXXXXXXXXXXXXXXXXXXXXXXXXXXXXXXXXXXXXXXXXXXXXXXXXXXXXXXXXXXXXXXXX-XXXXXXXXXXXXXXXXXXXXXXXXXXXXXXXXXXXXXXXXXXXXXXXXXXXXXXXXXXXX-XXXXXXXXXXXXXXXXXXXXXXXXXXXXXXXXXX
