----------------------------------------------------------------------------------------------------------------------------------------------------------------------------------
----------------------------------------------------------------------------------------------------------------------------------------------------------------------------------
----------------------------------------------------------------------------------------------------------------------------------------------------------------------------------
----------------------------------------------------------------------------------------------------------------------------------------------------------------------------------
----------------------------------------------------------------------------------------------------------------------------------------------------------------------------------
----------------------------------------------------------------------------------------------------------------------------------------------------------------------------------
--------------------------------------------------------------------SSS!----------------------------------------------------------------------------------------------------------
-------------------------------------------------------------------------------------1--------------------------------------------------------------------------------------------
------------------------------------------------------------------------------SSSSS-----------------------------------------------------------------------------------------------
----------------------------------------------------------------------------------------------------------------------------------------------------------------------------------
----#------------!---#-------!-----#--#-----SU----SS!S-#-------S@------C------------------------SS!S---tt-------------SU---#---------SS------#--#---------------------------#-#---
----##---------------##-----------##--##---------------##----------------------------------------------tt------------------##---------------##--##--------tt---------------##-##--
----###-----tt-------###---------###--###--------------###--tt-----------------------------------------tt---------tt-#-----###--tt---------###--###-------tt--------------###-###-
-M--####----tt---k---####----k--####--####-------------####-tt--g-------g-g--#######-----g-g-----------tt----gg---tt##-----####-tt-g-g----####--####------tt-g---gg----g-g-tt-####
XXX-XXXXXXXXXXXXXXXXXXXXXXXXXXXXXXXXXXXXXXXXXXXXXXXXXX-XXXXXXXXXXXXXXXXXXXXXXXXXXXXXXXXXXXXXXXXXXXXXXXXXXXXXXXXXXXXXXXXXXX-XXXXXXXXXXXXXXXXXXXXXXXXXXXXXXXXXXXXXXXXXXXXXXXXXX-XXXX
XXX-XXXXXXXXXXXXXXXXXXXXXXXXXXXXXXXXXXXXXXXXXXXXXXXXXX-XXXXXXXXXXXXXXXXXXXXXXXXXXXXXXXXXXXXXXXXXXXXXXXXXXXXXXXXXXXXXXXXXXX-XXXXXXXXXXXXXXXXXXXXXXXXXXXXXXXXXXXXXXXXXXXXXXXXXX-XXXX
