--------------------------------------------------------------------------------------------------------------------------------------------------------------------------------------------
--------------------------------------------------------------------------------------------------------------------------------------------------------------------------------------------
--------------------------------------------------------------------------------------------------------------------------------------------------------------------------------------------
--------------------------------------------------------------------------------------------------------------------------------------------------------------------------------------------
--------------------------------------------------------------------------------------------------------------------------------------------------------------------------------------------
--------------------------------------------------------------------------------------------------------------------------------------------------------------------------------------------
--------------------------------------------------------------------------------------------------------------------------------------------------------------------------------------------
--------------------------------------------------------------------------------------------------------------------------------1-----------------------------------------------------------
--------------------------------------------------------------------------##---------------------SSSSS---SSS!-------------------------------------------------------------------SSSSS---SSS!
-------------------------------------------------------------------------###----------------------------------------------------------------------------------------------------------------
-----!---#----------##------tt------tt--------------------tt------------####-------------t----tt--------------------!---SU-----------------SS------#--#--------------tt---------------------
---------##--------###------tt------tt-----------tt-------tt-------tt--------------------t----tt--------------------------------------------------##--##-------------tt---------------------
---------###------####------tt------tt-----------tt-------tt-------tt----------XTT-------t----tt------------C------------------------------------###--###-----tt-#---tt--------------------C
-M---k---####----#####-#######------tt----gg-----tt-g----g-g-tt----tt-g---g-g---tt-------tt------------#######----------------gg---------g-g----####--####----tt##---tt--------------g-g-tt-
XXXXXXXXXXXXXXXXXXXXXX-XXXXXXXXXXXXXXXXXXXXXXXXXXXXXXXXXXXXXXXXXXXXXXXXXXXXXXXXXXXXXXXXXXXXXXXXXXXXXXXXXXXXXXXXXXXXXXXXXXXXXXXXXXX---XXXXXXXXXXXXXXXXXXXXXXXXXXXXXXXXXXXXXXXXXXXXXXXXXXXXXX-
XXXXXXXXXXXXXXXXXXXXXX-XXXXXXXXXXXXXXXXXXXXXXXXXXXXXXXXXXXXXXXXXXXXXXXXXXXXXXXXXXXXXXXXXXXXXXXXXXXXXXXXXXXXXXXXXXXXXXXXXXXXXXXXXXX---XXXXXXXXXXXXXXXXXXXXXXXXXXXXXXXXXXXXXXXXXXXXXXXXXXXXXX-
