----------------------------------------------------------------------------------------------------------------------------------------------------------------------------------
----------------------------------------------------------------------------------------------------------------------------------------------------------------------------------
----------------------------------------------------------------------------------------------------------------------------------------------------------------------------------
----------------------------------------------------------------------------------------------------------------------------------------------------------------------------------
----------------------------------------------------------------------------------------------------------------------------------------------------------------------------------
----------------------------------------------------------------------------------------------------------------------------------------------------------------------------------
-----------------------------------------------------------------------------------------------------------------------------------------------------------------tt---------------
-----------------------------------------------------------1-----------------------------------------------------------------------------------------------------tt---------------
--------------------------------------------------SSS!---------------------------------------------------------------------------##-----tt-----------------------tt---------------
----------------------------------------------------------------------------------------------------1---------------------------###-----tt---------------------####-------1-------
-----SS!S------------------------------------------------------------------------------------tt------------------------##---U--####-----tt------!---#---------#####---------------
-------------tt-------------------tt---------------------------------------------------------tt-----------------------###---------------------------##-------######---------------
-------------tt---XTT-------------tt---XTT-----------C---------------------------------------tt----------------------####---------------------------###------######---------------
-M-----------tt-g--tt-------------tt-g--tt----#######-----------------gg---g-g--------------------#######-----gg-#######---------g-g------------k---####-------------gg-#######---
XXXXXXXXXXXXXXXXXXXXXXXXXXXXXXXXXXXXXXXXXXXXXXXXXXXXXXXXXXXXX---XXXXXXXXXXXXXXXXXXXXXXXXXXXXXXX---XXXXXXXXXXXXXXXXXXXXXXXXXXXXXXXXXXXXX---XXXXXXXXXXXXXXXXXXXXXXXXXXXXXXXXXXXXXXXX
XXXXXXXXXXXXXXXXXXXXXXXXXXXXXXXXXXXXXXXXXXXXXXXXXXXXXXXXXXXXX---XXXXXXXXXXXXXXXXXXXXXXXXXXXXXXX---XXXXXXXXXXXXXXXXXXXXXXXXXXXXXXXXXXXXX---XXXXXXXXXXXXXXXXXXXXXXXXXXXXXXXXXXXXXXXX
