---------------------------------------------------------------------------------------------------------------------------------------------------------------------------
---------------------------------------------------------------------------------------------------------------------------------------------------------------------------
---------------------------------------------------------------------------------------------------------------------------------------------------------------------------
---------------------------------------------------------------------------------------------------------------------------------------------------------------------------
---------------------------------------------------------------------------------------------------------------------------------------------------------------------------
---------------------------------------------------------------------------------------------------------------------------------------------------------------------------
--------------------------------------tt-----------------------------------------------------------------------------------------------------------------------------------
--------------------------------------tt-----------------------------------------------------------------------------------------------------------------------------------
--------------------------------------tt------------------SSSSS---SSS!------------------------------------##---------------------------------------------------------------
------------------------------------#####-------------###------------------------------------------------###---------------------------------1----------------1------------
-----------SU-------##-------------######-----tt------###----------------!-----#--#----------------SS!--####----------SS----#--------------------------tt------------------
-------------------###----------------###-----tt------###---------------------##--##--------tt------------------------------##-------------------------tt------------------
------------------####----------------###-----tt---tt-###------------C-------###--###-------tt------------------------------###---XTT------------------tt------------------
-M---------------#####---gg------------------------tt------------g-g-tt--k--####--####------tt-g-----------------gg-g-g-----####---tt------------------------g-g-tt--------
XXXX---XXXXXXXXXXXXXXX-XXXXXXXXXXXXXXXXXXXXXXXXX--XXXXXXXXXXXXXXXXXXXXXXXXXXXXXXXXXXXXXXXXXXXXXXXXXXXXXX---XXXXXXXXXXXXXXXXXXXXXXXXXXXXXXXXXXXXXXXXXXXXXX-XXXXXXXXXX---XXXX
XXXX---XXXXXXXXXXXXXXX-XXXXXXXXXXXXXXXXXXXXXXXXX--XXXXXXXXXXXXXXXXXXXXXXXXXXXXXXXXXXXXXXXXXXXXXXXXXXXXXX---XXXXXXXXXXXXXXXXXXXXXXXXXXXXXXXXXXXXXXXXXXXXXX-XXXXXXXXXX---XXXX
