------------------------------------------------------------------------------------------------------------------------------------------------------------------------------------
------------------------------------------------------------------------------------------------------------------------------------------------------------------------------------
------------------------------------------------------------------------------------------------------------------------------------------------------------------------------------
------------------------------------------------------------------------------------------------------------------------------------------------------------------------------------
------------------------------------------------------------------------------------------------------------------------------------------------------------------------------------
------------------------------------------------------------------------------------------------------------------------------------------------------------------------------------
------------------------------------------------------------------------------------------------------------------------------------------------------------------------------------
---------------------------------------------------------------------------------------------------------------------------------------1--------------------------------------------
--------------------------------------------------------------------------------------------------------------------##------------------------------SSSSS---SSS!SSSSS---SSS!--------
-------------------------------------------------------------------------------------------------------------------###--------------------------------------------------------------
---S@S!S----SS!S--SS------#--#------#-----------------S@S!S----SS------#--#----------------SS----#-------SS!S-----####----#-----------------------##--------------------------------
-------------------------##--##-----##--------------------------------##--##---------------------##-----------------------##---------------------###--------------------------------
------------------------###--###----###-----tt-XTT-------------------###--###--------------------###----------------------###-----tt------------####-----------C-----------C--------
-M--g-----------g-g----####--####---####----tt--tt-----g-----g-g----####--####-----g-g-ttg-g-----####---------------g-g---####----tt-------g-g--------------------------------------
XXXXXXXXXXXXXXXXXXXXXXXXXXXXXXXXXXX-XXXXXXXXXXXXXXXXXXXXXXXXXXXXXXXXXXXXXXXXXXXXXXXXXXXXXXXXXXXXXXXXXXXXXXXXXXXXXXXXXXXXX-XXXXXXXXXXXXXXXXXXXXXXXXXXXXXXXX--XXXXXXXXXX--XXXXXXXXXX--
XXXXXXXXXXXXXXXXXXXXXXXXXXXXXXXXXXX-XXXXXXXXXXXXXXXXXXXXXXXXXXXXXXXXXXXXXXXXXXXXXXXXXXXXXXXXXXXXXXXXXXXXXXXXXXXXXXXXXXXXX-XXXXXXXXXXXXXXXXXXXXXXXXXXXXXXXX--XXXXXXXXXX--XXXXXXXXXX--
