----------------------------------------------------------------------------------------------------------------------------------------------------------------------------------
----------------------------------------------------------------------------------------------------------------------------------------------------------------------------------
----------------------------------------------------------------------------------------------------------------------------------------------------------------------------------
----------------------------------------------------------------------------------------------------------------------------------------------------------------------------------
----------------------------------------------------------------------------------------------------------------------------------------------------------------------------------
----------------------------------------------------------------------------------------------------------------------------------------------------------------------------------
--------------------------------------------------------------------------------SSSSS---SSS!-------------------------------tt-----------------------------------------------------
---------------------------------------------------------------------------------------------------------------------------tt-----------------------------------------------------
---------------------------------------------------------------------------------------------------------------------------tt-----------------------------------------------------
---------------------------------------------------------------------------1---------------------------------------------#####------1---------------------------------------------
----#------------!---#--------tt----------------------------------S@S!S--------------------C---S@S!S----SS----#------tt--#####--------------S@S!S--------------!---S@S!S-------##-
----##---------------##-------tt------------------------------------------------------------------------------##-----tt--#####------------------------------------------------###-
----###-----tt-------###------tt---------------------XTT------tt-#-------XXXXXXXXXX---------------------------###----tt--#####-tt--------------------------------------------####-
-M--####----tt---k---####-----tt----------g-g-tt------tt------tt##-g-----XXXXXXXXXX--g-g--------g-----g-g-----####-------------tt-#######----g--------g-g-tt--------g-------#####-
XXX-XXXXXXXXXXXXXXXXXXXXXXXXXXXXXXXXXXXXXXXXXXXXXXXXXXXXXXXXXXXXXXXXXXXXXXXXXXXXXXXXXXXXXXXXXXXXXXXXXXXXXXXXXXXXXXXXXXXXXXXXXXXXXXXXXXXXXXXXXXXXXXXXXXXXXXXXXXXXXXXXXXXXXXXXXXXXX-
XXX-XXXXXXXXXXXXXXXXXXXXXXXXXXXXXXXXXXXXXXXXXXXXXXXXXXXXXXXXXXXXXXXXXXXXXXXXXXXXXXXXXXXXXXXXXXXXXXXXXXXXXXXXXXXXXXXXXXXXXXXXXXXXXXXXXXXXXXXXXXXXXXXXXXXXXXXXXXXXXXXXXXXXXXXXXXXXX-
