------------tt----------------------------------------------------------
------------------------------------------------------------------------
------XXXXXXXXXXXXXXX------------------C--------------------------------
------XXXXXXXXXXXXXXX--g-g--------------##------1-----------------------
---------------------XXXXXXXXXXXXXXXXX--##------------------------------
---------------------XXXXXXXXXXXXXXXXX--##------------------------------
-----------------------------------#######------------------------------
-------------------------------------------------#####------------------
------------------------------------------------######------------------
-------------------1---------------------------#######------------------
------tt----------------------!-----!-----#--#-#######-------------##---
------tt---------------------------------##--##-------------------###---
------tt--XTT---------------------------###--###-----------------####---
-M----tt---tt----#######------------k--####--####----g-g----------------
XXXXXXXXXXXXXXXXXXXXXXXXXXXXXXXXXXXXXXXXXXXXXXXXXXXXXXXXXXXXXXXXXXXX----
XXXXXXXXXXXXXXXXXXXXXXXXXXXXXXXXXXXXXXXXXXXXXXXXXXXXXXXXXXXXXXXXXXXX----
