S----SSSSSSSSSSSSSSSSSSSSSSSSSSSSSSSSSSSSSSSSSSSSSSSSSSSSSSSSSSSSSSSSSSSSSSSSSSSSSSSSSSSSSSSSSSSSSSSSSSSSSSSSSSSSSSSSSSSSSSSSSSSSSSSSSSSSSSSSSSSSSSSSS
S----SSSSSSSSSSSSSSSSSSSSSSSSSSS------SSSSS-----SSSSSSSSSSSSSSSSSSSSSSSSSSSSSSSSSSSSS-----SSSSSSSSSSSSSSSSSSSSSSSSSSS-------SSSSSSSSSSSSSS-------SSSSS
S----SSSSSSSSSSSSSSSSSSSSSSSSSSS------SSSSS-----SSSSSS------------SSSSSSSS-----SSSSSS-----SSSSSSSSSSSSSSSSSSSS--------------SSSSSSSSSSSSSS-------SSSSS
S------------SSSSS-------SSSSSSS----------------SSSSSS------------SSSSSSSS----------------SSSSSSSSSSSSSS---------------------------SSSSSSS------------
S-----------------------------------------------------------------------------------------------------------------------------------------------------
S-----------------------------------------------------------------------------------------------------------------------------------------------------
S-----------------------------------------------------------------------------------------------------------------------------------------------------
S-----------------------------------------------------------------------------------------------------------------------------------------------------
S-----------------------------------------------------------------------------------------------------------------------------------------------------
S-----------------------------------ooooo---------------------------------------oooo------------------------------------------------------------------
S-----------------------------------------------------------------------------------------------------------------------*--------------tt-------------
S------------------------------------oooooo---------------------------ooooo----oooo----ooooo--------------------------*-*-----oSS------tt-tt----------
S-----------------------------------r-------------------------------------------yk------------------------------------*-*--------------tt-tt----------
S----------------------------------XXXXXXXXXXX--XXXXXXXXXXX---XXXX--oooo----XXXXXXXXX--oooooo---XXX-----yk-r-XXXXXXXXXXXXX---oooo--XXXXXXXXXXXXXXXXXX-
SXXXXXXXXXXXXXX--XXXXXXX--XXXXXXXXXXXXXXXXXXXX--XXXXXXXXXXX---XXXX--------k-XXXXXXXXX-k-------R-XXX---XXXXXXXXXXXXXXXXXXXX---------XXXXXXXXXXXXXXXXXX-
SXXXXXXXXXXXXXX--XXXXXXX--XXXXXXXXXXXXXXXXXXXX--XXXXXXXXXXX---XXXXXXXXXXXXXXXXXXXXXXXXXXXXXXXXXXXXXXXXXXXXXXXXXXXXXXXXXXXXXXXXXXXXXXXXXXXXXXXXXXXXXXXX

