S----SSSSSSSSSSSSSSSSSSSSSSSSSSSSSSSSSSSSSSSSSSSSSSSSSSSSSSSSSSSSSSSSSSSSSSSSSSSSSSSSSSSSSSSSSSSSSSSSSSSSSSSSSSSSSSSSSSSSSSSSSSSSSSSSSSSSSSSSSSSSSSSSS
S---------------SSSSSSS-----SSSSSSSSSSSSSS-----SSSSSSSSSSS-----SSSSSSSSSSSSSSSSSSSSSSSSSSSSSSSSSSSSSSSSSSSSSSSSSSSSSSSSSSSSSSS-------SSSSSSSSSSSSSSSSS
S---------------SSSSSSS-----SSSSSSSSSSSSSS---------------------SSSSSS-------SSSSSSSSSSSSSSSSSSSSSSSSSSSSSSSSSSSSSSSSSSSSS------------SSSSSS-----------
S---------------------------SSSSSSSSSSSSSS---------------------SSSSSS---------------------------------------SSSSS--------------------SSSSSS-----------
S-----------------------------------------------------------------------------------------------------------------------------------------------------
S-----------------------------------------------------------------------------------------------------------------------------------------------------
S-----------------------------------------------------------------------------------------------------------------------------------------------------
S-----------------------------------------------------------------------------------------------------------------------------------------------------
S---------------------------------------------SSSSo---------------------------------------------------ooooS-----*----*-----oooooSo--------------------
S---------------------------------------------------------------------------------------------------------------*-*--*---------------Tt---------------
S--------------*-------------------------------oo--------------------------------------------ooooooo---oooooo---*-*--*-*---oooo------Tt-tt---Tt-------
S--------------*------------------------------y-------------------*---*-----------------------------------g-----*-*--*-*---R---------Tt-tt---Tt-------
S--------------*---------XXXX--------oooo---XXXXXXXX---------XX---*---*-*-------XXXXXX-------oooo----XXXXXXXXXXXXXXXXXXXXXXXXXXXXXXXXXXXXXXXXXXX------
S--------------*---------XXXX-------------y-XXXXXXXX---------XXXXXXXXXXXXX---oo-XXXXXX---------g-----XXXXXXXXXXXXXXXXXXXXXXXXXXXXXXXXXXXXXXXXXXX------
SXXXXXXXXXXXXXXXXXXX--XXXXXXX-------XXXXXXXXXXXXXXXXXXXXXXXXXXXXXXXXXXXXXX----g-XXXXXXXXXXXXXXXXXXXXXXXXXXXXXXXXXXXXXXXXXXXXXXXXXXXXXXXXXXXXXXXX------
SXXXXXXXXXXXXXXXXXXX--XXXXXXXXXXXXXXXXXXXXXXXXXXXXXXXXXXXXXXXXXXXXXXXXXXXXXXXXXXXXXXXXXXXXXXXXXXXXXXXXXXXXXXXXXXXXXXXXXXXXXXXXXXXXXXXXXXXXXXXXXXXXXXXX

