S----SSSSSSSSSSSSSSSSSSSSSSSSSSSSSSSSSSSSSSSSSSSSSSSSSSSSSSSSSSSSSSSSSSSSSSSSSSSSSSSSSSSSSSSSSSSSSSSSSSSSSSSSSSSSSSSSSSSSSSSSSSSSSSSSSSSSSSSSSSSSSSSSS
S----SSSSSSSSSSSSSSSSSSSSSS------SSSSSSSSSSSSS------SSSSSSSSSSSSSSSSSSSSSSSSSSSSSSSSSSSSSSSSSSSSSSSSSSSS------SSSSSSSSSSSSSSSSSSSSSSSSSSSSSSSSSSSSSSSS
S--------------------------------SSSSSSSSSSSSS--------------SSSSSSSSSSSSS-----SSSSSSSSSSSSSS-----SSSSSSS------SSSSSSS-------------SSSSSSS-------------
S--------------------------------SSSSS-----------------------------------------------SSSSSSS------------------SSSSSSS-------------SSSSSSS-------------
S-----------------------------------------------------------------------------------------------------------------------------------------------------
S-----------------------------------------------------------------------------------------------------------------------------------------------------
S-----------------------------------------------------------------------------------------------------------------------------------------------------
S-----------------------------------------------------------------------------------------------------------------------------------------------------
S-----------------------------------------------------------------------------------------------------------------------------------------------------
S--------------------------------------------------------------------------------------------------------------------------------------Sooo-----------
S-----------------------------------ooSoo-------------------------------------------------------------------oSoo-------------oooooo-------------------
S--------------------------------------------ooooo------------Sooo--------------------ooo---------------------------------------G-------ooooo---------
S------------------------ooo---k----ooooo----------------------------------tt--tt----------XXXX----------------------------XXXXXXXXX------g-----------
S------------------XXXX--y---XXXXXX------------ooo----*-----ooooo----------tt--tt---XXXXXXXXXXX---XXXXX----------XXXXX-----XXXXXXXXXXXXXXXXXXXX-------
SXXXXXXXXXXXXXXXXXXXXXXXXXXXXXXXXXXXXXXXXXX---R--r--XXXXXX--y---R----XXXXXXXXXXXXXXXXXXXXXXXXXXXXXXXXXXXXXXXXXXXXXXXXX-----XXXXXXXXXXXXXXXXXXXX-g--r-X
SXXXXXXXXXXXXXXXXXXXXXXXXXXXXXXXXXXXXXXXXXXXXXXXXXXXXXXXXXXXXXXXXXXXXXXXXXXXXXXXXXXXXXXXXXXXXXXXXXXXXXXXXXXXXXXXXXXXXXXXXXXXXXXXXXXXXXXXXXXXXXXXXXXXXX

