S----SSSSSSSSSSSSSSSSSSSSSSSSSSSSSSSSSSSSSSSSSSSSSSSSSSSSSSSSSSSSSSSSSSSSSSSSSSSSSSSSSSSSSSSSSSSSSSSSSSSSSSSSSSSSSSSSSSSSSSSSSSSSSSSSSSSSSSSSSSSSSSSSS
S----SSSSSSSSSSSSSSSSSSSSSSSSSSSSSSSSSSSSSSSSSSSSSSSSSSSSSSSSSSSSSSSSSS----------------SSSSSSSSSSSSSSSSSSSSSSSSSSSSSSSS-------------SSSSSSSSSSSSSSSSSS
S----SSSSSSSSSSSSSS--------SSSSSSSSSSSSSSSSSSSSSSSSSS-------------SSSSS----------------SSSSSSS-------------SSSSSSSSSSSS-------------SSSSSS-------SSSSS
S--------------------------SSSSSSSSSSSSS------SSSSSSS-------------SSSSS----------------SSSSSSS-------------SSSSS--------------------------------------
S-----------------------------------------------------------------------------------------------------------------------------------------------------
S-----------------------------------------------------------------------------------------------------------------------------------------------------
S-----------------------------------------------------------------------------------------------------------------------------------------------------
S-----------------------------------------------------------------------------------------------------------------------------------------------------
S-----------------------------------------------------------------------------------------------------------------------------------------------------
S----------------------------------------------------------------------oooSSS-------------oooSSo---------------Sooo-----------------------------------
S---------------oSo-----------------------------------------------------------------------------------------------------------------------------------
S----------------------ooooooo-----r----------------------------oSoo---ooooo-----------------oo--------------ooooooo-----------tt----tt---------------
S------------------------------XXXXXXX---------------XXXXX----------------------ooo--------------------*-----------g-----------tt----tt---------------
S----------------------ooooo---XXXXXXX-----XXX---oo--XXXXX------------XXXXXXXXX----------XXXXXXXXX-----*----XXXXXXXXXX--------XXXXXXXXXXXX-tt---Tt----
SXXXXXXXXXX----XXXXXX----------XXXXXXX-----XXX-Gy-R--XXXXX----R-------XXXXXXXXXXXXXXXXX--XXXXXXXXX---*-*----XXXXXXXXXXXXXXXXXXXXXXXXXXXXXX-tt---Tt----
SXXXXXXXXXXXXXXXXXXXXXXXXXXXXXXXXXXXXXXXXXXXXXXXXXXXXXXXXXXXXXXXXXXXXXXXXXXXXXXXXXXXXXXXXXXXXXXXXXXXXXXXXXXXXXXXXXXXXXXXXXXXXXXXXXXXXXXXXXXXXXXXXXXXXX

