S----SSSSSSSSSSSSSSSSSSSSSSSSSSSSSSSSSSSSSSSSSSSSSSSSSSSSSSSSSSSSSSSSSSSSSSSSSSSSSSSSSSSSSSSSSSSSSSSSSSSSSSSSSSSSSSSSSSSSSSSSSSSSSSSSSSSSSSSSSSSSSSSSS
S----SSSSSS-------------SSSSSSSSSSSSSSSSSSSSSSSSSSSSSSSSSSSSSSSSSSSSSSSSSSS-------------SSSSSSSSSSSSSSSSSSSSSSSSSSSSSSSSSSSS-------SSSSSSSSSSSSSS-----
S-----------------------------------SSSSSSS-------SSSSSS------SSSSS---------------------SSSSSSSSSSSSSSSSSSSSS-------SSSSSSSS-------SSSSSS-------------
S-------------------------------------------------SSSSSS------SSSSS--------------------------SSSSSSSS---------------SSSSSSSS-------SSSSSS-------------
S-----------------------------------------------------------------------------------------------------------------------------------------------------
S-----------------------------------------------------------------------------------------------------------------------------------------------------
S-----------------------------------------------------------------------------------------------------------------------------------------------------
S-----------------------------------------------------------------------------------------------------------------------------------------------------
S----------------oooo---------------------------------------------------------------------------------------------------------------------------------
S------------------------------------------------tt-----------------------------------------------------------------------------------------SSooSo----
S---------------------------oSoSSoSo-------------tt---tt--ooooo------------------------------------oooo--oooooSoo-------------------------------------
S----------------g-------------------------------tt---tt--------------------------------------------------------------------------ooSoo----ooooooo----
SXXXXXXXXXXXX---XXXXXXXXXX---ooooooo----oooo--XXXXXXXXXXX-ooooo-----------XXXXXX--------------------oo---oooooooo-----------g--------------rr-r--K----
SXXXXXXXXXXXX---XXXXXXXXXX--y-------------g---XXXXXXXXXXX-----------------XXXXXXXXXXX-------ooo----r----------------------XXXXXXX-------XXXXXXXXXXX---
SXXXXXXXXXXXX---XXXXXXXXXXXXXXXXXXXXXXXXXXXXXXXXXXXXXXXXXXXXXXXXXXXXXXXXXXXXXXXXXXXXXXXXXX-------XXXXXXXXXXXXXXXXXX-----XXXXXXXXX---r---XXXXXXXXXXXXXX
SXXXXXXXXXXXXXXXXXXXXXXXXXXXXXXXXXXXXXXXXXXXXXXXXXXXXXXXXXXXXXXXXXXXXXXXXXXXXXXXXXXXXXXXXXXXXXXXXXXXXXXXXXXXXXXXXXXXXXXXXXXXXXXXXXXXXXXXXXXXXXXXXXXXXX

