S----SSSSSSSSSSSSSSSSSSSSSSSSSSSSSSSSSSSSSSSSSSSSSSSSSSSSSSSSSSSSSSSSSSSSSSSSSSSSSSSSSSSSSSSSSSSSSSSSSSSSSSSSSSSSSSSSSSSSSSSSSSSSSSSSSSSSSSSSSSSSSSSSS
S-----------SSSSSSSSSSSSSSSSSSSSSSSSSSSSSSSSSSSSSSSS-------SSSSS-----SSSSSSS-----SSSSSSSSSSSSSSSSSSSSSSSSSSSSSSSSSSS-------SSSSSSSSSSSSSSS-------SSSSS
S-----------SSSSS-----------SSSSSS-------SSSSSSSSSSS-----------------SSSSSSS-----SSSSSSSSSS--------------------------------SSSSSSSSSSSSSSS------------
S---------------------------SSSSSS-------SSSSSSSSSSS-----------------SSSSSSS-----SSSSS-------------------------------------SSSSSSS--------------------
S-----------------------------------------------------------------------------------------------------------------------------------------------------
S-----------------------------------------------------------------------------------------------------------------------------------------------------
S-----------------------------------------------------------------------------------------------------------------------------------------------------
S-----------------------------------------------------------------------------------------------------------------------------------------------------
S--------------SSooS----------------------------------------------------------------------------------------------------------------------------------
S---------------------------------------------------------------------------------------------Soo-----------------------------------------------------
S---------------oooo----------------oSoS---------------------ooo---ooSo--------------------------------ooo--------------------------------------------
S------------------g-g------------------------ooooo------------------------ooo--------------oooo-------r-------tt---tt-----oSoo----r------------------
S-----------XXXXXXXXXXXXXX-----XX----oooo------------------------------------y----------------rr---XXXXXXXX----tt---tt-----------XXXXXX---*-----------
SXXXXXXXXXXXXXXXXXXXXXXXXX-----XX-----------ooooooo---------k-------g----XXXXXXXXX------XXXXXXXXXXXXXXXXXXXXXXXXXXXXXXXXX-oooo---XXXXXX---*-----oooo--
SXXXXXXXXXXXXXXXXXXXXXXXXX---XXXXXXXXXXXXXX--kk-K---------XXXXXXXXXXXXXXXXXXXXXXXXXXXXXXXXXXXXXXXXXXXXXXXXXXXXXXXXXXXXXXX----r-k-XXXXXX---*--------r--
SXXXXXXXXXXXXXXXXXXXXXXXXXXXXXXXXXXXXXXXXXXXXXXXXXXXXXXXXXXXXXXXXXXXXXXXXXXXXXXXXXXXXXXXXXXXXXXXXXXXXXXXXXXXXXXXXXXXXXXXXXXXXXXXXXXXXXXXXXXXXXXXXXXXXX

