S----SSSSSSSSSSSSSSSSSSSSSSSSSSSSSSSSSSSSSSSSSSSSSSSSSSSSSSSSSSSSSSSSSSSSSSSSSSSSSSSSSSSSSSSSSSSSSSSSSSSSSSSSSSSSSSSSSSSSSSSSSSSSSSSSSSSSSSSSSSSSSSSSS
S-----------SSSSSSSSSSSSSSSSSS-----SSSSSSSSSSSSSSSSSSSSSSSS-------SSSSSSSSSS--------------SSSSSSSSSSSSSSSSSSSSSSSSSSSSS------SSSSSS------SSSSSS-------
S------------------------SSSSS-----SSSSSSSSSSSSSSSSSSSSSSSS-------SSSSS--------------------------SSSSSSSSSSSSSSS-------------SSSSSS-------------------
S------------------------SSSSS-----SSSSSSSSSSSSS------SSSSS-------SSSSS-------------------------------------------------------------------------------
S-----------------------------------------------------------------------------------------------------------------------------------------------------
S-----------------------------------------------------------------------------------------------------------------------------------------------------
S-----------------------------------------------------------------------------------------------------------------------------------------------------
S-----------------------------------------------------------------------------------------------------------------------------------------------------
S----------------------------------------------------------------------------------------*-*--oSooS-----ooSooSoo--------------------------------------
S------------------------------------oSoo------------------------------------------------*-*----------------------------------------------------------
S---------------ooSo---------------------------------------oooo---oSoSS------------------*-*--ooooooo-----ooooo----oooS-------------------------------
S------------------------------------oo-------------------------------------oSo-----*----*-*----kk-g----rk--------------------------------------------
S---------------ooooo------XX-------------XXXXX---------------------oooo----------XXXXXXXXXXXXXXXXXXXXXXXXXXXXXXXX---oooo----oooo---------------------
S--------------gr-----XXXXXXX------XXXXXXXXXXXXXXXXXXXXXXX--------K-------ooooo---XXXXXXXXXXXXXXXXXXXXXXXXXXXXXXXX--K-y--------------oo----XXXXXX-----
S------------XXXXXXXXXXXXXXXX------XXXXXXXXXXXXXXXXXXXXXXXXXXXXXXXXXXXXXX------k--XXXXXXXXXXXXXXXXXXXXXXXXXXXXXXXXXXXXXXXXXXXXXXXXX-y----XXXXXXXXXXXXX
SXXXXXXXXXXXXXXXXXXXXXXXXXXXXXXXXXXXXXXXXXXXXXXXXXXXXXXXXXXXXXXXXXXXXXXXXXXXXXXXXXXXXXXXXXXXXXXXXXXXXXXXXXXXXXXXXXXXXXXXXXXXXXXXXXXXXXXXXXXXXXXXXXXXXX

