S----SSSSSSSSSSSSSSSSSSSSSSSSSSSSSSSSSSSSSSSSSSSSSSSSSSSSSSSSSSSSSSSSSSSSSSSSSSSSSSSSSSSSSSSSSSSSSSSSSSSSSSSSSSSSSSSSSSSSSSSSSSSSSSSSSSSSSSSSSSSSSSSSS
S----------SSSSSSSSSSSSSSSSSSSSSSSSSSSSSSSSSSSSSSSSSSSS--------SSSSSSSSSSSSSSSSSSSSSSSSSSS-----------------SSSSSSSSSSSSSSSSSSSSSSSSSSSSSSSSSSSSSSSSSSS
S-----------------SSSSSSSSSSSSSSSSSSSSSS--------SSSSSSS--------------SSSSSSSSSSSSSSSSSSSSS-----------------SSSSSS-------SSSSSSSSSSSSSSSSSSSSSSSS------
S-------------------------------SSSSSSSS------------------------------------SSSSSS-------------------------SSSSSS-------SSSSSSSSSSS-------------------
S-----------------------------------------------------------------------------------------------------------------------------------------------------
S-----------------------------------------------------------------------------------------------------------------------------------------------------
S-----------------------------------------------------------------------------------------------------------------------------------------------------
S-----------------------------------------------------------------------------------------------------------------------------------------------------
S-----------------------------------------------oSSooo--------------------------oSoo-----------------ooo----------------------------------------------
S---------------------ooo--------------------------------------SoS------------------------------------------------------------------------------------
S---------------------------------------------oooooo----------------------------ooo----------------oooooo---------------------------------------------
S-------------------------------------------------r------g-------oo---ooS------g----------ooS---------------------------------------------------------
S------------XX-----y---g------------g------XXXXXXXXXXXXXXXXX----------------XXXXXXXXX-----------XXXXXXXXXX-----------------------------------------XX
S------------XX----XXXXXXX-----XXXXXXXX-----XXXXXXXXXXXXXXXXXXXXXXXX--oooooo-XXXXXXXXX--ooooooo--XXXXXXXXXX--ooo-XXXXXXXX--------------------ooo----XX
S------------XX----XXXXXXXXXXXXXXXXXXXX-----XXXXXXXXXXXXXXXXXXXXXXXX---------XXXXXXXXX-----------XXXXXXXXXX------XXXXXXXXXXX----K--G-XXXXXX---------XX
SXXXXXXXXXXXXXXXXXXXXXXXXXXXXXXXXXXXXXXXXXXXXXXXXXXXXXXXXXXXXXXXXXXXXXXXXXXXXXXXXXXXXXXXXXXXXXXXXXXXXXXXXXXXXXXXXXXXXXXXXXXXXXXXXXXXXXXXXXXXXXXXXXXXXX

