S----SSSSSSSSSSSSSSSSSSSSSSSSSSSSSSSSSSSSSSSSSSSSSSSSSSSSSSSSSSSSSSSSSSSSSSSSSSSSSSSSSSSSSSSSSSSSSSSSSSSSSSSSSSSSSSSSSSSSSSSSSSSSSSSSSSSSSSSSSSSSSSSSS
S----SSSSSSS-------------SSSSSSSSSSSSSSSSSSSSSSSSSS--------SSSSS-------SSSSSSSSSSSSSSSSSSSSSSSSSSSS-----SSSSSSSSSSSSSSSSSSS------SSSSSSSSSSSSSSSSSSSSS
S------------------------SSSSSS-------SSSSSSSSSSSSS--------SSSSS-------SSSSSSSSSSSSSSS------------------SSSSSSSSSSSSSS----------------SSSSSSS-------SS
S------------------------SSSSSS-------SSSSSS----------------------------------SSSSSSSS------------------SSSSSSSSSSSSSS--------------------------------
S-----------------------------------------------------------------------------------------------------------------------------------------------------
S-----------------------------------------------------------------------------------------------------------------------------------------------------
S-------------------------------------------------------------------B---------------------------------------------------------------------------------
S-------------------------------------------------------------------*---------------------------------------------------------------------------------
S---------------------oSS-------------------------------------------*----ooo---------------------*---------------------------Soo----------------------
S-------------------------------------------------------------------*----------------------------*-------------------oSo------------------------------
S------------oSoS----ooooo---------------------ooo---------------SoSoo------------ooo------------*-------------------------ooooo----------------------
S-------------------------------------------------------y----------------------------------------*------------------oooo--------yk-------------oooo---
S--------------ooo--XXXXXXXXX----XX--------------------XXXXXXX--ooo----XXXXXX----XXXXXXXX-ooooo-XXXXX--------------------XXXXXXXXXXX---------------r--
S-----------------g-XXXXXXXXX----XX------------r-------XXXXXXX---y-----XXXXXX----XXXXXXXX-------XXXXXXXXXXXXXXXXXXXXXXXXXXXXXXXXXXXX------XXXXXXXXXXXX
SXXXXXXXXXXXXXXXXXXXXXXXXXXXX----XX-------XXXXXXXXXXXXXXXXXXXXXXXXXXXXXXXXXXX----XXXXXXXXXXXXXXXXXXXXXXXXXXXXXXXXXXXXXXXXXXXXXXXXXXXXX----XXXXXXXXXXXX
SXXXXXXXXXXXXXXXXXXXXXXXXXXXX----XXXXXXXXXXXXXXXXXXXXXXXXXXXXXXXXXXXXXXXXXXXX-XXXXXXXXXXXXXXXXXXXXXXXXXXX---XXXXXXXXXXXXXXXXXXXXXXXXXXXXXXXXXXXXXXXXXX

