S----SSSSSSSSSSSSSSSSSSSSSSSSSSSSSSSSSSSSSSSSSSSSSSSSSSSSSSSSSSSSSSSSSSSSSSSSSSSSSSSSSSSSSSSSSSSSSSSSSSSSSSSSSSSSSSSSSSSSSSSSSSSSSSSSSSSSSSSSSSSSSSSSS
S-----------SSSSSSSSSSSSSSSSSSSSSSSSSSSSS-----SSSSSSSSSSSSS-----SSSSSSSSSSSSSSSSSSSSSSSSSS-----SSSSSSSSSSSSSSSSSSSSSSSSSSSSSSSSSSSSSSSSSSSSSSSSSSSSSSS
S----------------------SSSSSSSSSSSSSSSSSS-----SSSSSSSS----------SSSSSSSSSSSS-------------------SSSSSSSSSSSSSSSSSSSS-----SSSSSSSS------------------SSSS
S----------------------SSSSSSSSSSSSSSSSSS-----SSSSSSSS----------SSSSSSSSSSSS-------------------SSSSSS-------------------SSSSSSSS----------------------
S-----------------------------------------------------------------------------------------------------------------------------------------------------
S-----------------------------------------------------------------------------------------------------------------------------------------------------
S-----------------------------------------------------------------------------------------------------------------------------------------------------
S-----------------------------------------------------------------------------------------------------------------------------------------------------
S-----------------------------------------------------------------------------------------------------------------------------------------------------
S----------------------------------------------------------ooSooS-----------------------------------------------------------------oSoS----------------
S-----------------------------------------------------------------------oSoSooo-----------------------------------------------------------------ooooo-
S-------------------------------------oo------r---------------ooooo------------------------------ooo-------------------ooSo-------oooooo--------------
S---------------------XXXXXX-----------------XXXXXX-----------------XXX-oooooo----------XXXXX------------tt----tt-------------------------------oooo--
S-----------ooo-------XXXXXX---------XXXXXX--XXXXXX-------XXXXXXXXXXXXX--------------oo-XXXXX-ooooooooo--tt----tt----oooooo---XXXXXXXXXXXXXXXX--------
SXXXXXXXXXX------XXXXXXXXXXXXXXXX----XXXXXXXXXXXXXX-----XXXXXXXXXXXXXXXXXXXXXXXXX-------XXXXX------------tt----tt-------------XXXXXXXXXXXXXXXXXXXXXXXX
SXXXXXXXXXXXXXXXXXXXXXXXXXXXXXXXXXXXXXXXXXXXXXXXXXXXXXXXXXXXXXXXXXXXXXXXXXXXXXXXXXXXXXXXXXXXXXXXXXXXXXXXXXXXXXXXXXXXXXXXXXXXXXXXXXXXXXXXXXXXXXXXXXXXXX

