S----SSSSSSSSSSSSSSSSSSSSSSSSSSSSSSSSSSSSSSSSSSSSSSSSSSSSSSSSSSSSSSSSSSSSSSSSSSSSSSSSSSSSSSSSSSSSSSSSSSSSSSSSSSSSSSSSSSSSSSSSSSSSSSSSSSSSSSSSSSSSSSSSS
S----SSSSSSSSSSSSSSSSSSSSSSSSSS------SSSSSSSSSSSSSSSSSSSSSSSSSSSSSSSSSS------SSSSSSSSSSSSSSSSSSSSSSSSSSSSSSSSSSS--------------SSSSSSSSSSSSSSSSSSSSSSSS
S----SSSSSSSSSSSSSSSSSSSSSSSSSS------SSSSSSSSSSSSSSSSSSSSSSSSSSSSSSSSSS-------------------SSSSSSSSSSSSSSSS--------------------SSSSSSSSSSSSSSSSSSSSSSSS
S-----------------SSSSSSS-----------------------------SSSSS-------------------------------SSSSSSSSSSSSSSSS--------------------SSSSSSSS-------SSSSSSSSS
S-----------------------------------------------------------------------------------------------------------------------------------------------------
S-----------------------------------------------------------------------------------------------------------------------------------------------------
S-----------------------------------------------------------------------------------------------------------------------------------------------------
S-----------------------------------------------------------------------------------------------------------------------------------------------------
S-----------------------------------------------------------------------------------------------------------------------------------------------------
S---------------------------------------------------------------------------------------------*---*---------------------------------------------------
S---------------------oooooo------------------------------------------------------------------*-*-*------ooo----Tt--------------tt--tt----------------
S--------------------------------oSo----------------------------------------------------------*-*-*-*-----------Tt----tt--------tt--tt----------------
S------------XXXXXX---oooooo--------------XX---XX-----------XXXX------------tt----------------*-*-*-*--XXXXXX---Tt----tt-XX-----tt--tt----------------
S------------XXXXXX------k------oooooo----XX---XX----tt-----XXXX------------tt---XXXX---XXXXXXXXXXXXXXXXXXXXXXXXXXXXXXXXXXXXXXXXXXXXXXXXXXXXXXXXXXXXXX
S------------XXXXXXXXXXXXXXXXX-y--------XXXX---XX----tt-----XXXXXXXX--XXXX--tt---XXXX---XXXXXXXXXXXXXXXXXXXXXXXXXXXXXXXXXXXXXXXXXXXXXXXXXXXXXXXXXXXXXX
SXXXXXXXXXXXXXXXXXXXXXXXXXXXXXXXXXXXXXXXXXXX---XXXXXXXXXXXXXXXXXXXXX--XXXXXXXXXXXXXXX---XXXXXXXXXXXXXXXXXXXXXXXXXXXXXXXXXXXXXXXXXXXXXXXXXXXXXXXXXXXXXX

