S----SSSSSSSSSSSSSSSSSSSSSSSSSSSSSSSSSSSSSSSSSSSSSSSSSSSSSSSSSSSSSSSSSSSSSSSSSSSSSSSSSSSSSSSSSSSSSSSSSSSSSSSSSSSSSSSSSSSSSSSSSSSSSSSSSSSSSSSSSSSSSSSSS
S----SSSSSSSSSSSSSSSSSSSSSSSSSSSSSSSSSSSSSSSSSSSSSSSSSSSSSSSSS-------SSSSSSSSSSSSSSSSSSSSSSSSSSSSSSSSS-------SSSSSSSSSSSSSSSSSSSS-----SSSSSSSSSSSSSSSS
S----SSSSSSS-----SSSSSSSSSSSSSSSSSSSSSS------------------SSSSS-------SSSSSSSSSSSSSSSSSSSS--------------------SSSSSSS-------SSSSSS-----SSSSSSSSSSSSSSSS
S----------------SSSSSSSSSSSSSS--------------------------SSSSS---------------SSSSS-----------------------------------------SSSSSS-------------SSSSSSSS
S-----------------------------------------------------------------------------------------------------------------------------------------------------
S-----------------------------------------------------------------------------------------------------------------------------------------------------
S-----------------------------------------------------------------------------------------------------------------------------------------------------
S-----------------------------------------------------------------------------------------------------------------------------------------------------
S--------------------------------------ooooo--------------------oooSooo-------------------------------------------------------------------------------
S-----------ooSo-------------SSSoo---------------oooo-------------------------------------------------------------------------------------------------
S---------------------------------------oo-------------oooSSoo-----oo---------------------------------------------------------------------------------
S------------ooo----SooSo--oooooooo-----------oooooo------------r--------------------------------------------------------ooooS------oSS--------oooo---
S---------------------------k--g---r-XXXXXXXX-----ry-----ooo---XXXXXXXXXXXXXXXXXXX---------ooo--------------------------------------------------------
S---------XXXXXXX---ooo---XXXXXXXXXXXXXXXXXXXXXXXXXXXX---y--r--XXXXXXXXXXXXXXXXXXXXXXXX----------------------ooo---------ooo-------oooooo------oooo---
S---------XXXXXXX--r------XXXXXXXXXXXXXXXXXXXXXXXXXXXXXXXXXXXXXXXXXXXXXXXXXXXXXXXXXXXXXXXXXXXXXX-----XXXX-------k-XXX---k----R----k---y--------------X
SXXXXXXXXXXXXXXXXXXXXXXXXXXXXXXXXXXXXXXXXXXXXXXXXXXXXXXXXXXXXXXXXXXXXXXXXXXXXXXXXXXXXXXXXXXXXXXXXXXXXXXXXXXXXXXXXXXXXXXXXXXXXXXXXXXXXXXXXXXXXXXXXXXXXX

