S----SSSSSSSSSSSSSSSSSSSSSSSSSSSSSSSSSSSSSSSSSSSSSSSSSSSSSSSSSSSSSSSSSSSSSSSSSSSSSSSSSSSSSSSSSSSSSSSSSSSSSSSSSSSSSSSSSSSSSSSSSSSSSSSSSSSSSSSSSSSSSSSSS
S----SSSSSSSSSSSSSSSSSSSSSSSSSSSSSSSSSSSSSSSSSSSSSS--------SSSSSSSSSSSSSSSSSSSSSSSSSSSSSSSSSSSSSSSSSSSSSSSSSSSS--------SSSSSS--------SSSSSSSSSSSSSSSSS
S----SSSSSSSSSSSSSSSSSSSSS--------SSSSSSS-----SSSSS----------------SSSSSSSSSSSS--------SSSSSSSSSSSSS-------------------SSSSSS--------SSSSSSS----------
S---------------------------------------------SSSSS----------------SSSSSSSSSSSS----------------------------------------SSSSSS-------------------------
S-----------------------------------------------------------------------------------------------------------------------------------------------------
S-----------------------------------------------------------------------------------------------------------------------------------------------------
S-----------------------------------------------------------------------------------------------------------------------------------------------------
S-----------------------------------------------------------------------------------------------------------------------------------------------------
S-----------------------------------------------------------------------------------------------------------------------ooSooS------------------------
S-----------------------------------------------------------------------------------------------------------------------------------------------------
S----------------------------------------------------------Tt-Tt---------------------------------------------Soooo-----oooooooo-----------------------
S-------------SoSo------------y-k---------Soo-------oo-----Tt-Tt----------SoSo----SSooSSS-----------------------------------------------oSooooo-------
S----------------------------XXXXXXXXX---------------------Tt-Tt---------------------------XX----------------ooo------XXXXXXXXXXX---------------------
S-----------ooooooo----ooooo-XXXXXXXXX---ooooo---XXXXXXXXXXXXXXXXXXXXXXX--oo--------ooo----XX-------------------------XXXXXXXXXXX---------oo----------
S-------------g-----------y--XXXXXXXXX-----yrr---XXXXXXXXXXXXXXXXXXXXXXX-------------------XX-------------XXXXXXXXXXXXXXXXXXXXXXX---------------XXXXXX
SXXXXXXXXXXXXXXXXXXXXXXXXXXXXXXXXXXXXXXXXXXXXXXXXXXXXXXXXXXXXXXXXXXXXXXXXXXXXXXXXXXXXXXXXXXXXXXXXXXXXXXXXXXXXXXXXXXXXXXXXXXXXXXXXXXXXXXXXXXXXXXXXXXXXX

