S----SSSSSSSSSSSSSSSSSSSSSSSSSSSSSSSSSSSSSSSSSSSSSSSSSSSSSSSSSSSSSSSSSSSSSSSSSSSSSSSSSSSSSSSSSSSSSSSSSSSSSSSSSSSSSSSSSSSSSSSSSSSSSSSSSSSSSSSSSSSSSSSSS
S----SSSSSSSSSSSSSSSSSSS------SSSSSSSSSSSSSSSSSSSSSSSSSSSS------------------SSSSSSSSSSSSS------SSSSSSSSSSSSSSSSSSS------SSSSSSSSSSSSSSSSSSSSSSSSSSSS--
S----SSSSS--------------------SSSSSSSS------------SSSSSSSS------------------------SSSSSSS------SSSSSSSSSSSSSSSSSSS------------------SSSSSSSSSSSSSSSS--
S-----------------------------SSSSSSSS---------------------------------------------------------SSSSSSSS-----SSSSSS------------------SSSSSSSS----------
S-----------------------------------------------------------------------------------------------------------------------------------------------------
S-----------------------------------------------------------------------------------------------------------------------------------------------------
S-----------------------------------------------------------------------------------------------------------------------------------------------------
S-----------------------------------------------------------------------------------------------------------------------------------------------------
S-------------------ooo------------------------ooSS------------------------------------------oSooS----------------------------------------------------
S--------------------------ooSSoo---------------------------------------------------------------------------------------------------------------------
S---------------------------------------------ooo------------------------oSoo---------------ooooooooo---------------------oooooo----------------------
S-------------------------oooo---------------------------------SSo------------------oooooo------------------ooSo-------------r--------------ooSS------
S-----------------XXXXXX----------XXXXXXXXXXXXXXXXXXX--XXXXX------------oooooo-------------XXXXXXXXXXX------------y----r-XXXXXXXX---------------------
S----------XXX----XXXXXXXXXXXXXXXXXXXXXXXXXXXXXXXXXXX--XXXXX---oooo------k-------XXXXXXXXXXXXXXXXXXXXXXXXX-oo----XXXXXXXXXXXXXXXX-oooo----oooooo------
SXXXXXXXXXXXXXXXXXXXXXXXXXXXXXXXXXXXXXXXXXXXXXXXXXXXX--XXXXX--y-----y-XXXXXXXXXXXXXXXXXXXXXXXXXXXXXXXXXXXX-------XXXXXXXXXXXXXXXX-y-------------r--XXX
SXXXXXXXXXXXXXXXXXXXXXXXXXXXXXXXXXXXXXXXXXXXXXXXXXXXXXXXXXXXXXXXXXXXXXXXXXXXXXXXXXXXXXXXXXXXXXXXXXXXXXXXXXXXXXXXXXXXXXXXXXXXXXXXXXXXXXXXXXXXXXXXXXXXXX

