S----SSSSSSSSSSSSSSSSSSSSSSSSSSSSSSSSSSSSSSSSSSSSSSSSSSSSSSSSSSSSSSSSSSSSSSSSSSSSSSSSSSSSSSSSSSSSSSSSSSSSSSSSSSSSSSSSSSSSSSSSSSSSSSSSSSSSSSSSSSSSSSSSS
S----SSSSSS-----SSSSSSSSSSSSSSSSSSS-------SSSSSSSSSSSSSSSSSSSSS------SSSSSSSSSSSSSSSSSSSSSSSSSSSSSSSSSSSSSSSSSSSSSSSSSSSSSSSSSSSSSSSSSSSSSSSSSSSSSSSSS
S---------------SSSSSSSS------------------SSSSSSSSSSSSS-------------------SSSSSS------SSSSSSSSSSSSSSSSSSSSSSSSSSSSSSSSSSSSSSSSSSSSSSSSSSSSSSSSSSSSSSSS
S-----------------------------------------SSSSSSSS------------------------SSSSSS-------------SSSSSSSSSSSSSSSSSS-------SSSSSSSSSSSSSSSSSSSSS--------SSS
S-----------------------------------------------------------------------------------------------------------------------------------------------------
S-----------------------------------------------------------------------------------------------------------------------------------------------------
S-----------------------------------------------------------------------------------------------------------------------------------------------------
S-----------------------------------------------------------------------------------------------------------------------------------------------------
S-----------------------------------------------------------------------------------ooo---------------------------------------------------------------
S----------------------oSooooo------------------------------------------------------------------------------------------------------------------------
S-------------------------------------------------------------------------oSSoo-----ooo---------------------------------------------------------------
S-----------oooSoooo--oooooooo----------------------------oooSoS-------------------------------------oooS-----------------oSoo------------------------
S----------------------y----------r-------oo-------------------------------oooo---XXXXXX-------------------------ooo-XX--------XXXXX--ooo-------------
S-----------ooooo----XXXXXXXXXXXXXXXXX----------XXXX-------ooooo---XXXX---k----g--XXXXXX------oooo---ooo---------K-r-XX--oo----XXXXX----y------------X
SXXXXXXXXXX----------XXXXXXXXXXXXXXXXXXXXXXXXXXXXXXX---------------XXXXXXXXXXXXXXXXXXXXXXXXXX---------------XXXXXXXXXXX--------XXXXXXXXXXX-----------X
SXXXXXXXXXXXXXXXXXXXXXXXXXXXXXXXXXXXXXXXXXXXXXXXXXXXXXXXXXXXXXXXXXXXXXXXXXXXXXXXXXXXXXXXXXXXXXXXXXXXXXXXXXXXXXXXXXXXXXXXXXXXXXXXXXXXXXXXXXXXXXXXXXXXXX

