S----SSSSSSSSSSSSSSSSSSSSSSSSSSSSSSSSSSSSSSSSSSSSSSSSSSSSSSSSSSSSSSSSSSSSSSSSSSSSSSSSSSSSSSSSSSSSSSSSSSSSSSSSSSSSSSSSSSSSSSSSSSSSSSSSSSSSSSSSSSSSSSSSS
S----SSSSSSSSSSSSSSS-------SSSSSSSSSSSSSSSSSSSSSSSSSSSSSSSSSSSSSSSSSSSSSSSSSSSS-------------SSSSSSSSSSSSSSSSSSSSSSSSSSSSSSSSSSSSSSSSSSSSSSSSS--------S
S------------SSSSSSS-------SSSSSSSSSSSSSSSSSSSSSSSSSSSSSSSSSSSSSSSSSSSSSS-------------------SSSSSSS------------SSSSSSSSSSSSSSSSSSSSSSSSSSSSSS--------S
S----------------------------------SSSSSSSS--------SSSSSSSS-------SSSSSSS--------------------------------------SSSSSSSSSSSSSS--------SSSSSSSS---------
S-----------------------------------------------------------------------------------------------------------------------------------------------------
S-----------------------------------------------------------------------------------------------------------------------------------------------------
S-----------------------------------------------------------------------------------------------------------------------------------------------------
S-----------------------------------------------------------------------------------------------------------------------------------------------------
S-----------------------------------------------------------------------------------------------------------------------------------------------------
S----------------------SSoooSoo----------------SSo---------------------------------------------------------------------------ooooo----ooo-------------
S----------------------------------------------------------------------ooSooSo-----------------oSoS----Soo--------------------------------------------
S-----------------------ooooo---------------ooooooo------------------------------oooooo-------------------------ooo-------ooooooo------------oSooS----
S-----------------XXX---------k---------------r-----XXXX--oo-----------oooo-----------------ooooo-----ooooo---------XXXXX--r-------------y------------
S----------XXXXXXXXXXXXXXXXXXXXX-----------XXXXXXXXXXXXX-r--k-k----------------XXXXXXXXXXXX----------------------oo-XXXXXXXXXXXXXXXXXXXXXXX--ooooooo--
S----------XXXXXXXXXXXXXXXXXXXXXXXXXXXXXX--XXXXXXXXXXXXXXXXXXXXXXX--XXXXXXXXXXXXXXXXXXXXXXXXXXXXXXXXXXXXXXXXX---g---XXXXXXXXXXXXXXXXXXXXXXX-----------
SXXXXXXXXXXXXXXXXXXXXXXXXXXXXXXXXXXXXXXXXXXXXXXXXXXXXXXXXXXXXXXXXXXXXXXXXXXXXXXXXXXXXXXXXXXXXXXXXXXXXXXXXXXXXXXXXXXXXXXXXXXXXXXXXXXXXXXXXXXXXXXXXXXXXX

