S----SSSSSSSSSSSSSSSSSSSSSSSSSSSSSSSSSSSSSSSSSSSSSSSSSSSSSSSSSSSSSSSSSSSSSSSSSSSSSSSSSSSSSSSSSSSSSSSSSSSSSSSSSSSSSSSSSSSSSSSSSSSSSSSSSSSSSSSSSSSSSSSSS
S---------SSSSS-----SSSSSSSSSSSSSSSSSSSSSSSSSSSSSSSSSSSSSSSSSSSSSSSSSSSSSS-------SSSSSSSSSSSSSSSSSSSSSSSSSSSSSSSSSSSSSSSS-------SSSSSSSSSSSSSSSSSSSS--
S---------SSSSS-----SSSSS-----SSSSSSSSSSSSSSSSSSSSSSSSSSSSSSSSSSSSSSSSSSSS-------SSSSSSSSSSSSSSSS-------SSSSS-------------------SSSSSSSSSSSSSSSSSSSS--
S---------SSSSS---------------SSSSSSSSSSSSSSSSSSSSSSSSSSSSSSSSSSSSSSSSSSSS------------------------------------------------------SSSSS-----------------
S-----------------------------------------------------------------------------------------------------------------------------------------------------
S-----------------------------------------------------------------------------------------------------------------------------------------------------
S-----------------------------------------------------------------------------------------------------------------------------------------------------
S-----------------------------------------------------------------------------------------------------------------------------------------------------
S---------------------------------------------------------------------------------------------------oSooo---------------------------------------------
S---------------------------------oSSSo-----------------oSoo--------------------ooo----------------------------------------oSo--------------------oSo-
S--------------------------------------------------------------------------------------------------oooooo-------ooo-----------------------------------
S----------------oo---------------ooo-------------------ooooo------------------oo----------SoSoo---k--y----------g------------------------------------
S-----------------g-XX----XXX-----------XXXX----------------gG----------XXXXX------k-XX-----------XXXXXXXX-----XXXXXXX---------XXXXXXXX---------------
S------------XXXXXXXXX----XXXXXXXXXXXXXXXXXX--oooooo---XXXXXXXX----oooo-XXXXXXXXXXXXXXX-oooooo----XXXXXXXXXXXXXXXXXXXX---XXXXXXXXXXXXXX---------XXXXXX
SXXXXXXXXXXXXXXXXXXXXXXXXXXXXXXXXXXXXXXXXXXX----y----XXXXXXXXXX---------XXXXXXXXXXXXXXX-----------XXXXXXXXXXXXXXXXXXXX---XXXXXXXXXXXXXXXXX------XXXXXX
SXXXXXXXXXXXXXXXXXXXXXXXXXXXXXXXXXXXXXXXXXXXXXXXXXXXXXXXXXXXXXXXXXXXXXXXXXXXXXXXXXXXXXXXXXXXXXXXXXXXXXXXXXXXXXXXXXXXXXXXXXXXXXXXXXXXXXXXXXXXXXXXXXXXXX

