S----SSSSSSSSSSSSSSSSSSSSSSSSSSSSSSSSSSSSSSSSSSSSSSSSSSSSSSSSSSSSSSSSSSSSSSSSSSSSSSSSSSSSSSSSSSSSSSSSSSSSSSSSSSSSSSSSSSSSSSSSSSSSSSSSSSSSSSSSSSSSSSSSS
S----SSSSSSSSSSSSSSSSSSSSSSSSSSSSSSSSSSSSSSSSSSSSSSSSSSSS------SSSSSSSSSSSSSSSSSSSSSSSSSSSSSSSSSSSSSSSSSSSSSSSSSSSSSSSSSSSSSSSSSSSS-----SSSSSSSSSSSSSS
S------------SSSSSSSSSSSSSSS---------------------SSSSSSSS-----------SSSSSSSS------SSSSSSSSSSSSSSSSSSSSS------------SSSSSSSS-------------SSSSSSSS------
S------------SSSSSSSS-------------------------------------------------------------SSSSSSSSSSSSSS-------------------SSSSSSSS-------------SSSSSSSS------
S-----------------------------------------------------------------------------------------------------------------------------------------------------
S-----------------------------------------------------------------------------------------------------------------------------------------------------
S-----------------------------------------------------------------------------------------------------------------------------------------------------
S-----------------------------------------------------------------------------------------------------------------------------------------------------
S---------------------------------------------Soooooo---------------------------oooooSSo--------------------------------------------------------------
S-----------------------------------oSSSo---------------oSS---------------------------------ooo---------------oSSo----------Soo-----------------------
S-------------------------------------------ooooooooo----------------------------oooo-----------------------------------------------------------------
S-----------------------ooo----------oo--------r---------ooo-----------ooSoooo--r---k-----oooooo---SSooSS-----ooo----------ooooo-------------oSSo-----
S------------------------------------------XXXXXXXXXXX---r--k-----ooo----------XXXXXXXXXX------------------------------------y---XXXX-----XX----------
S-----------------XXXXXXXXXXX-----XXXXXXXXXXXXXXXXXXXXXXXXXXXXX-r---r---oooooo-XXXXXXXXXXXXXXXXXX-ooooooo--XXXXXXXXX-----XXXXXXXXXXXX-----XX------XXXX
S---------------k-XXXXXXXXXXXXXXXXXXXXXXXXXXXXXXXXXXXXXXXXXXXXXXXXXXXX------K--XXXXXXXXXXXXXXXXXX----------XXXXXXXXXXXXXXXXXXXXXXXXXXXXXXXXX------XXXX
SXXXXXXXXXXXXXXXXXXXXXXXXXXXXXXXXXXXXXXXXXXXXXXXXXXXXXXXXXXXXXXXXXXXXXXXXXXXXXXXXXXXXXXXXXXXXXXXXXXXXXXXXXXXXXXXXXXXXXXXXXXXXXXXXXXXXXXXXXXXXXXXXXXXXX

