S----SSSSSSSSSSSSSSSSSSSSSSSSSSSSSSSSSSSSSSSSSSSSSSSSSSSSSSSSSSSSSSSSSSSSSSSSSSSSSSSSSSSSSSSSSSSSSSSSSSSSSSSSSSSSSSSSSSSSSSSSSSSSSSSSSSSSSSSSSSSSSSSSS
S-----------SSSSS--------SSSSSSSSSSSSSSSSSSSS-------SSSSSSSSSSSSSSSSSSSS-------SSSSSSSSSSSSSSSSSSSSSSSSSSSSSSSSSS-------SSSSSSSSSSSSSSSSSSSSSSSSSSSSSS
S-----------SSSSS----------------SSSSSS---------------------------SSSSSS-------SSSSSSSSSSS-----SSSSSSSSSSSSSSSSSS-------SSSSSSSSSSSSSS--------SSSSSSSS
S-----------SSSSS-------------------------------------------------SSSSSS-----------------------------------SSSSSS-------------SSSSSSSS----------------
S-----------------------------------------------------------------------------------------------------------------------------------------------------
S-----------------------------------------------------------------------------------------------------------------------------------------------------
S-----------------------------------------------------------------------------------------------------------------------------------------------------
S-----------------------------------------------------------------------------------------------------------------------------------------------------
S---------------------------------------------------------------------------oSo-----------------------------------------------------------------------
S---------------------------------------oooSS--------------------------------------------oSSoSoo---------oSSoo----------------------------------------
S--------------------------------------------------oo---ooo---------------------------------------------------------------------------oSoSoo----------
S-----------------------------------------ooooo--G--------------------------------------oooooooo------oooooooo----------------ooo----------------ooo--
S-----------------------------------XXX-g-------XXXXXX----oo--------XXXXXXXXXXXXXXXXX---------g--XXXX---------------XXXX-------------ooooooo----G--G--
S-----------oo---------k------------XXXXXXXXXXXXXXXXXX---ryy--------XXXXXXXXXXXXXXXXXXXXXXXXXXXXXXXXXXXXXXXXXXX-----XXXX----oooo---------y-----XXXXXXX
SXXXXXXXXX--kk-r--XXXXXXX--XXX-Y----XXXXXXXXXXXXXXXXXXXXXXXXX--r----XXXXXXXXXXXXXXXXXXXXXXXXXXXXXXXXXXXXXXXXXXX-----XXXX------------XXXXXXXXXXXXXXXXXX
SXXXXXXXXXXXXXXXXXXXXXXXXXXXXXXXXXXXXXXXXXXXXXXXXXXXXXXXXXXXXXXXXXXXXXXXXXXXXXXXXXXXXXXXXXXXXXXXXXXXXXXXXXXXXXXXXXXXXXXXXXXXXXXXXXXXXXXXXXXXXXXXXXXXXX

