S----SSSSSSSSSSSSSSSSSSSSSSSSSSSSSSSSSSSSSSSSSSSSSSSSSSSSSSSSSSSSSSSSSSSSSSSSSSSSSSSSSSSSSSSSSSSSSSSSSSSSSSSSSSSSSSSSSSSSSSSSSSSSSSSSSSSSSSSSSSSSSSSSS
S----SSSSSSSSSSSSSSS-----SSSSSSSSSSSSSSSSSSSSSSSSSSSSSSSSSSSSSSSS-------SSSSSSSSSSSSSSSSSSSSSSSSSSSSSSSSSSSSSSSSSSSSSSSSSSSSSSSSSSSSSSSSSSS--------SSS
S----SSSSSSSSSSSSSSS-----SSSSSSSSSSSSSSSSSSSSSSS-----------SSSSSS---------------SSSSSSSSSSSSSS--------SSSSSSS-----SSSSSSSSSSSSSSSSSSSS----------------
S------------SSSSSSS------------SSSSS----------------------SSSSSS---------------SSSSSSSSSSSSSS--------SSSSSSS-----SSSSSSS-------SSSSSS----------------
S-----------------------------------------------------------------------------------------------------------------------------------------------------
S-----------------------------------------------------------------------------------------------------------------------------------------------------
S-----------------------------------------------------------------------------------------------------------------------------------------------------
S-----------------------------------------------------------------------------------------------------------------------------------------------------
S---------------------------ooo--------------------------------------oooSooS---------------------------Sooo----Sooooo---------------------------------
S--------------------------------oooo-----------------------------------------------------------------------------------------------------------------
S---------------------------ooo----------------------------------------ooooo------------oSo----------oooooo------oooo--------------------ooo----------
S--------------oSo------------g---ooo-----ooooS-------------Soo---------y---------------------------y-------------y---k-------------------------------
S-----------------------XXXXXXXX----------------------XXXX----------XXXXXXXXXXX--------------------XXXXXXXXXXXXXXXXXXXXXXXX-----oooo----ooo-----------
S---------------ooo-----XXXXXXXXXXXXXX--ooooo----XXXXXXXXX-oooooo---XXXXXXXXXXX--XXXXX-------oooo--XXXXXXXXXXXXXXXXXXXXXXXXXXX--r-----------------XXXX
S-----------------------XXXXXXXXXXXXXX--g--------XXXXXXXXX--------XXXXXXXXXXXXXXXXXXXXXXXXXX--kR---XXXXXXXXXXXXXXXXXXXXXXXXXXXXXXXXXXXXXXXXXXXXXXXXXXX
SXXXXXXXXXXXXXXXXXXXXXXXXXXXXXXXXXXXXXXXXXXXXXXXXXXXXXXXXXXXXXXXXXXXXXXXXXXXXXXXXXXXXXXXXXXXXXXXXXXXXXXXXXXXXXXXXXXXXXXXXXXXXXXXXXXXXXXXXXXXXXXXXXXXXX

