S----SSSSSSSSSSSSSSSSSSSSSSSSSSSSSSSSSSSSSSSSSSSSSSSSSSSSSSSSSSSSSSSSSSSSSSSSSSSSSSSSSSSSSSSSSSSSSSSSSSSSSSSSSSSSSSSSSSSSSSSSSSSSSSSSSSSSSSSSSSSSSSSSS
S----SSSSSS-------SSSSSS-----SSSSSSSS------SSSSSSSSSSSSSSSSSSSSSSSSSSSSSSSSSSSSSSSSSSSSSSSSSSSSSSSSSSSSSSSSS----------SSSSSSSSSSSSSSSSSS--------SSSSSS
S----------------------------SSSSSSSS------SSSSSS--------SSSSSSSSSSSSSSSSSSSSSSSSSS------SSSSSSSSSSSSSSSSSSS----------SSSSSSSSSSSSSSSSSS--------SSSSSS
S----------------------------SSSSSSSS------SSSSSS----------------SSSSSSS-----SSSSSS------SSSSSSSSSSSSSSSSSSS---------------SSSSSSS--------------SSSSSS
S-----------------------------------------------------------------------------------------------------------------------------------------------------
S-----------------------------------------------------------------------------------------------------------------------------------------------------
S-----------------------------------------------------------------------------------------------------------------------------------------------------
S-----------------------------------------------------------------------------------------------------------------------------------------------------
S----------------ooooSooo--------------------------------------------------ooo------------------------------oooSo-------------------------------------
S----------------------------------------------------------Soooo--------------------------------------------------------------------------------------
S------------------ooo-----------------------------------------------------oooo-----------------------------oooo-------------oSSoo--------------------
S------------------k------------------SoSo--------------oooooooo-----------r-----------------------------------------------------------X---X----------
S----------XXXXXXXXXXXXXXX--oooo---------------X--X---------------------XXXXXXXXXX-------------------------XXXXXXXXXXXX--XXX----------XX---XX---------
S----------XXXXXXXXXXXXXXX---k----------------XX--XX---XXXXXXXXXX---Tt--XXXXXXXXXX-----ooo-----Tt----------XXXXXXXXXXXX--XXX-r--r----XXX---XXX--XXXXXX
S----------XXXXXXXXXXXXXXXXXXXXXXXXX---------XXX--XXX--XXXXXXXXXX---Tt--XXXXXXXXXX-----r-------Tt--XXXX----XXXXXXXXXXXX--XXXXXXXXXXXXXXX---XXXXXXXXXXX
SXXXXXXXXXXXXXXXXXXXXXXXXXXXXXXXXXXXXXXXXXXXXXXX--XXXXXXXXXXXXXXXXXXXXXXXXXXXXXXXXXXXXXXXXXXXXXXXXXXXXXXXXXXXXXXXXXXXXX--XXXXXXXXXXXXXXX---XXXXXXXXXXX

