S----SSSSSSSSSSSSSSSSSSSSSSSSSSSSSSSSSSSSSSSSSSSSSSSSSSSSSSSSSSSSSSSSSSSSSSSSSSSSSSSSSSSSSSSSSSSSSSSSSSSSSSSSSSSSSSSSSSSSSSSSSSSSSSSSSSSSSSSSSSSSSSSSS
S----SSSSSSSSSSSSSSSSSSSSSSSSSS------SSSSSSSSSSSSSSSSSSSSSSSSSSSSSS-----SSSSSSSSSSSSSS--------------SSSSSSS-----SSSSSSSS-----SSSSS--------SSSSSSSSSSSS
S------------SSSSSSSSSSSS-----------------SSSSSSSSSSSSSSSSSSSS----------SSSSSSSSSSSSSS--------------SSSSSSS------------------SSSSS--------SSSSSSSSSSSS
S-----------------------------------------------------------------------SSSSSS------------------------------------------------------------------SSSSSS
S-----------------------------------------------------------------------------------------------------------------------------------------------------
S-----------------------------------------------------------------------------------------------------------------------------------------------------
S-----------------------------------------------------------------------------------------------------------------------------------------------------
S-----------------------------------------------------------------------------------------------------------------------------------------------------
S-----------------------------------------------------------------------------------------------------------------------------------------------------
S-------------------------------------------------------------------------------------ooo--------Soooo------------------------------------------------
S----------------oo--------------------------------------------------------------------------------------oSSo-----------------------------------------
S---------------------------------------------SSSo----X---X------ooSo---------------ooooooo------ooo----------------------------oo-------------ooSS---
SXXXXXXXXXXXXXXXXXXX-----------XXXXX---XXXXX--------XXX---XXXXXX-------------XXXXX-----------------------ooo-------------------------XXXXX------------
SXXXXXXXXXXXXXXXXXXX-----------XXXXX---XXXXX--oo----XXX---XXXXXX-oooo---XXXXXXXXXXXXXXXXXXXX---XXXXXXXXX----k------------------XXXXXXXXXXX----ooooooo-
SXXXXXXXXXXXXXXXXXXX------XXXXXXXXXX---XXXXX--k-----XXX---XXXXXX----y---XXXXXXXXXXXXXXXXXXXX---XXXXXXXXXXXXXXXXXX----XXXXX-----XXXXXXXXXXX-------k-g--
SXXXXXXXXXXXXXXXXXXXXXXXXXXXXXXXXXXX---XXXXXXXXXXXXXXXX---XXXXXXXXXXXXXXXXXXXXXXXXXXXXXXXXXXXXXXXXXXXXXXXXXXXXXXXXXXXXXXXXXXXXXXXXXXXXXXXXXXXXXXXXXXXX

