S----SSSSSSSSSSSSSSSSSSSSSSSSSSSSSSSSSSSSSSSSSSSSSSSSSSSSSSSSSSSSSSSSSSSSSSSSSSSSSSSSSSSSSSSSSSSSSSSSSSSSSSSSSSSSSSSSSSSSSSSSSSSSSSSSSSSSSSSSSSSSSSSSS
S----------SSSSSSSSSSSSSSSSSSSSSSSSSSSSSSSSSSSSSSSSSSSSSSSSSSSS-------SSSSS--------SSSSSSSSSSSSSSSSSSSSSSSSSSSSSSSSSSSSSSSSSSSS-----SSSSS-------SSSSSS
S----------SSSSSSSSSSSSSSS-----SSSSSSSSSSSSSSSSSSSSSSSSSSSSSSSS--------------------SSSSSSSSSSSSSSSSSSSSSSSSSSSSSSSS-----SSSSSSS-----SSSSS-------SSSSSS
S----------SSSSSSSS------------SSSSSSSSSS------------------------------------------------SSSSSSSSSSSSS------------------SSSSSSS----------------------S
S-----------------------------------------------------------------------------------------------------------------------------------------------------
S-----------------------------------------------------------------------------------------------------------------------------------------------------
S-----------------------------------------------------------------------------------------------------------------------------------------------------
S-----------------------------------------------------------------------------------------------------------------------------------------------------
S-----------------------------------------------------------------------------ooSSSoo-----------------------------------------------------------------
S---------------------------------------------------------------------------------------oSSooooo-----------------------------------------------oooo---
S-----------------------------------oooSoSoo----------------------------------oooo--------------------oooooSoo----------------------------------------
S------------X---X-------ooSooooo--------------------------------X--X-------------------ooooo-----------------------------*----------SSoSS-------ooo--
SXXXXXXXXXXXXX---XXX---------------ooooooooo-XXX---XXX----------XX--XX--XXXXXXXXXXXXXX--------r----------ooo---------*----*--XXXXX------------g------X
SXXXXXXXXXXXXX---XXX----oooooo-----g---------XXX---XXX--------XXXX--XXXXXXXXXXXXXXXXXXXXXXXXXXXXX--------k--------XXXXXXXXXXXXXXXX--ooooo----XXXXXXXXX
SXXXXXXXXXXXXX---XXXXXX---------y-XXXXXXXXXXXXXX---XXX--------XXXX--XXXXXXXXXXXXXXXXXXXXXXXXXXXXX----XXXXXXXXXXX--XXXXXXXXXXXXXXXX-----------XXXXXXXXX
SXXXXXXXXXXXXX---XXXXXXXXXXXXXXXXXXXXXXXXXXXXXXX---XXXXXXXXXXXXXXX--XXXXXXXXXXXXXXXXXXXXXXXXXXXXXXXXXXXXXXXXXXXXXXXXXXXXXXXXXXXXXXXXXXXXXXXXXXXXXXXXXX

