S----SSSSSSSSSSSSSSSSSSSSSSSSSSSSSSSSSSSSSSSSSSSSSSSSSSSSSSSSSSSSSSSSSSSSSSSSSSSSSSSSSSSSSSSSSSSSSSSSSSSSSSSSSSSSSSSSSSSSSSSSSSSSSSSSSSSSSSSSSSSSSSSSS
S----SSSSSSSSSSSSSSSSS--------SSSSSSSSSSSSSSSSSSSSSSSSSSSSSSSSS--------SSSSSSSSSSSSSSS------SSSSSSSSSSSSSSSSSSSSSSSSSSSSSSSSSSSSSSSSSSSSSSSSSSSS------
S----------------SSSSS--------SSSSSSSSSSSSSSSSS-------------------------------SSSSSSSS------SSSSSSSSSSSSSSS--------SSSSSSSSSSSSSSSS-------------------
S----------------SSSSS--------SSSSSS-------------------------------------------------------------------------------SSSSSSSSSSSSSSSS-------------------
S-----------------------------------------------------------------------------------------------------------------------------------------------------
S-----------------------------------------------------------------------------------------------------------------------------------------------------
S-----------------------------------------------------------------------------------------------------------------------------------------------------
S-----------------------------------------------------------------------------------------------------------------------------------------------------
S-----------------------------ooSoS---------------------------------------------*---------------------------------------------------------------------
S-------------------------------------------------------------------------------*--*---------------------------------Sooooo---------------------------
S------------------------------ooooooo------------------------------------------*--*-----------------------------------------ooSoooo------------------
S-------------------------------r-k-----------*---------ooo---------------------*--*------X--X--------------------oooooo------------------tt---tt-----
S-----------XXX---------XXXXXXXXXXXXXXX-------*--XXXXXX-y--yr-----------------XXXXXXXX---XX--XX----------------*-------K-----ooooooo------tt---tt-----
SXXXXXXXXXXXXXX---------XXXXXXXXXXXXXXX-------*--XXXXXXXXXXXXXXXXXXXXXXXX-----XXXXXXXX--XXX--XXX----g-----*----*-XXXXXXXXXXX----------XXXXXXXXXXXXXX--
SXXXXXXXXXXXXXX---------XXXXXXXXXXXXXXX----XXXXXXXXXXXXXXXXXXXXXXXXXXXXXX-----XXXXXXXXXXXXX--XXXXXXXXXXX--*----*-XXXXXXXXXXXXXXXXXXXXXXXXXXXXXXXXXXX--
SXXXXXXXXXXXXXXXXXXXXXXXXXXXXXXXXXXXXXXXXXXXXXXXXXXXXXXXXXXXXXXXXXXXXXXXXXXXXXXXXXXXXXXXXXX--XXXXXXXXXXXXXXXXXXXXXXXXXXXXXXXXXXXXXXXXXXXXXXXXXXXXXXXXX

