S----SSSSSSSSSSSSSSSSSSSSSSSSSSSSSSSSSSSSSSSSSSSSSSSSSSSSSSSSSSSSSSSSSSSSSSSSSSSSSSSSSSSSSSSSSSSSSSSSSSSSSSSSSSSSSSSSSSSSSSSSSSSSSSSSSSSSSSSSSSSSSSSSS
S-----------SSSSSSSSSSSSSSSSSSSSSSSSSSSS------SSSSSS--------SSSSSS------SSSSSSSSSSSSSSSSSSSSSSSSSSSSSSSSSSSSSSSSSSS-------SSSSSSSS------SSSSSSSSSSSSSS
S----------------SSSSSSSSSSSSSSSSSSSSSSS------SSSSSS--------SSSSSS------SSSSSSSSSSSSSSS--------------------SSSSSSSS---------------------SSSSSSSSSSSS--
S------------------------SSSSSSSSSSSSSSS------SSSSSS--------SSSSSS------SSSSSSS----------------------------SSSSSSSS-----------------------------------
S-----------------------------------------------------------------------------------------------------------------------------------------------------
S-----------------------------------------------------------------------------------------------------------------------------------------------------
S-----------------------------------------------------------------------------------------------------------------------------------------------------
S-----------------------------------------------------------------------------------------------------------------------------------------------------
S----------------------------oooSoo-------------------------------------------------------------------------------------------------------------------
S-----------------------------------------------------------------------------------------------------------------------------------------------------
S------------tt--------------oooooooo--ooooooo-----------------Sooo-----------------------------------------SSo-------------oSoooo-------------ooSo---
S------------tt----------------r----r----------------------------------------------------------------ooo----------------------------------------------
SXXXXXXXXXXXXXXXX----------XXXXXXXXXXX----oo-----oooo--------ooooo----------XXXXX---ooo--------XXX------------------------oooooo----oooo------ooo----X
SXXXXXXXXXXXXXXXX-------oo-XXXXXXXXXXX-------r---------XXXX-k---------------XXXXX--------------XXXXXXXXXXX--------------------------------------g----X
SXXXXXXXXXXXXXXXXXXX-R--k--XXXXXXXXXXXXXXXXXXXXXXXXXXXXXXXXXXXXXXXXXX-------XXXXXXXXXXXXXX-----XXXXXXXXXXXXXXXXX--------XXXXXXXXXXXXXXXXXXXXXXXXXXXXXX
SXXXXXXXXXXXXXXXXXXXXXXXXXXXXXXXXXXXXXXXXXXXXXXXXXXXXXXXXXXXXXXXXXXXXXXXXXXXXXXXXXXXXXXXXXXXXXXXXXXXXXXXXXXXXXXXXXXXXXXXXXXXXXXXXXXXXXXXXXXXXXXXXXXXXX

