S----SSSSSSSSSSSSSSSSSSSSSSSSSSSSSSSSSSSSSSSSSSSSSSSSSSSSSSSSSSSSSSSSSSSSSSSSSSSSSSSSSSSSSSSSSSSSSSSSSSSSSSSSSSSSSSSSSSSSSSSSSSSSSSSSSSSSSSSSSSSSSSSSS
S----SSSSSSSSSSSSSSSSSSS-------SSSSSSSSSSSSSS-------SSSSSSSSSSSSSSSSSSSSSSSSSS-----SSSSSSS---------------SSSSSSSSSSSSSSSSSSSSSSSSSSSS-----SSSSSSSSSSSS
S----SSSSSSSSSSS----------------------SSSSSSS-------SSSSSSSSSSSSSSSSSSSS---------------------------------SSSSSSSSSSSSSSSSSSSSSSS----------------------
S----SSSSS----------------------------SSSSSSS-------SSSSSSS----------------------------------------------SSSSS-----SSSSSSSSSSSSS----------------------
S-----------------------------------------------------------------------------------------------------------------------------------------------------
S-----------------------------------------------------------------------------------------------------------------------------------------------------
S-----------------------------------------------------------------------------------------------------------------------------------------------------
S-----------------------------------------------------------------------------------------------------------------------------------------------------
S---------------------------------------------------------------------------ooo-----------------------------------------------------------------------
S--------------------ooooo-------------SooSSo---------------------------------------------------------------------------------------------------------
S------------------------------------------------------------------oSo------ooo-------------------------------------oSooooo-------------------------X-
S--------------------oooo--------------ooo------SoSooo---------------------g----------------------------------------------------SSoooo-------------XX-
S-------------------r----------------------------------------------------XXXXXXX---XXXX------ooo-----XXXX------------oooooo------------------XXXXXXXX-
SXXXXXXXXXXX-----XXXXXXXXXXX-------XXXXXXXXXXX--ooooooo---XXXXXXXX--g----XXXXXXX---XXXX-----------XXXXXXX----------------yk----ooooooo-------XXXXXXXX-
SXXXXXXXXXXXXXXXXXXXXXXXXXXXXXXXXXXXXXXXXXXXXX-g--------XXXXXXXXXXXXXXXXXXXXXXXXXXXXXXXXXXXXXXXXXXXXXXXXX----XXXXXXXXXXXXXXXX--r---k---------XXXXXXXX-
SXXXXXXXXXXXXXXXXXXXXXXXXXXXXXXXXXXXXXXXXXXXXXXXXXXXXXXXXXXXXXXXXXXXXXXXXXXXXXXXXXXXXXXXXXXXXXXXXXXXXXXXXXXXXXXXXXXXXXXXXXXXXXXXXXXXXXXXXXXXXXXXXXXXX-

