S----SSSSSSSSSSSSSSSSSSSSSSSSSSSSSSSSSSSSSSSSSSSSSSSSSSSSSSSSSSSSSSSSSSSSSSSSSSSSSSSSSSSSSSSSSSSSSSSSSSSSSSSSSSSSSSSSSSSSSSSSSSSSSSSSSSSSSSSSSSSSSSSSS
S------------SSSSSSSSSSSSSSSSSSSSSSSSSSSSSSSSSSSSSSSSSSSSSSSSSSSSSSSSSSSSSSSSSS--------SSSSSSSSSSSSSS------SSSSSSSSSSSSSSSSSSS------SSSSSS-----SSSSSSS
S------------SSSSSSSSSSSSSS--------SSSSSSSSSSSSSSSSSSSSSSSSSSSSSSSSSSSSS---------------SSSSSSSSSSSSSS------------------------------------------SSSSSS-
S------------SSSSSSS--------------------SSSSSSSS-----------------------------------------------------------------------------------------------SSSSSS-
S-----------------------------------------------------------------------------------------------------------------------------------------------------
S-----------------------------------------------------------------------------------------------------------------------------------------------------
S-----------------------------------------------------------------------------------------------------------------------------------------------------
S-----------------------------------------------------------------------------------------------------------------------------------------------------
S------------------------oooo------------------------------------------------------------------------------oSoo---------------------------------------
S----------------oSo----------------------------------------------------------------------------------------------------------------------------------
S-------------------------------------------------------------*------oo------------------------------------ooooo---oSo--------------------------------
S---------------oooooo---------------ooSSooo----ooo-------*---*--------------SSoSoo----------------------------y------------------------ooo-----------
S-----------------------XXXXXX----------------------------*---*-XXXXXXXXXX-------------------------------XXXXXXXX-oooooo-------------------------XXXXX
S------------XXXXXXXXXXXXXXXXX--------oooooo--XXXXXXXXX---*---*-XXXXXXXXXX----ooo------XXXXXX------------XXXXXXXX------rg-XXXXXXXXXX-ooooo-------XXXXX
S------------XXXXXXXXXXXXXXXXX-------------gk-XXXXXXXXXXXXXXXXXXXXXXXXXXXX-------------XXXXXX--XXXXXX----XXXXXXXXXXXXXXXXXXXXXXXXXXX-------------XXXXX
SXXXXXXXXXXXXXXXXXXXXXXXXXXXXXXXXXXXXXXXXXXXXXXXXXXXXXXXXXXXXXXXXXXXXXXXXXXXXXXXXXXXXXXXXXXXXXXXXXXXXXXXXXXXXXXXXXXXXXXXXXXXXXXXXXXXXXXXXXXXXXXXXXXXXX

