S----SSSSSSSSSSSSSSSSSSSSSSSSSSSSSSSSSSSSSSSSSSSSSSSSSSSSSSSSSSSSSSSSSSSSSSSSSSSSSSSSSSSSSSSSSSSSSSSSSSSSSSSSSSSSSSSSSSSSSSSSSSSSSSSSSSSSSSSSSSSSSSSSS
S----SSSSSSSS--------SSSSSSSSSSSSSSSSSSSSSSSSSSSSSSSSSSSSSSSSSSSSSSSSSSSS------SSSSSSSSSSSS-----SSSSSSSSSSSSSSSSSSSSSSSSSSSSSSSSSSSSSSSSSSSSSSSSSSSSSS
S----SSSSSSSS--------SSSSSSSSSSSSSSSSSSSSSSSSS-----SSSSSSSSSSSSSS--------------SSSSSSSSSSSS-----SSSSSSSSSSSSSSSSSSSSSSSSSSSS-----SSSSSSSSSSSSSS-----SS
S----SSSSSSSS--------SSSSS-------SSSSSSS------------------SSSSSSS-------------------------------------SSSSSS---------------------SSSSSS-------------SS
S-----------------------------------------------------------------------------------------------------------------------------------------------------
S-----------------------------------------------------------------------------------------------------------------------------------------------------
S-----------------------------------------------------------------------------------------------------------------------------------------------------
S-----------------------------------------------------------------------------------------------------------------------------------------------------
S------------------------------------------------------------------------------------------------------------SSo-------------------ooSo---------------
S-------------oooSoS--------------------------------------------------------------------------------SoooS---------------------------------------------
S----------------------------------------------------------oSoo--oooooSo-------------------oooo-----------------------------------oooooo--------------
S--------------ooooo----------------oooSo----r-------------------------------------------------------ooooo-----r--------------------------------------
S---------------------XXXXX---------------XXXXXXX---------ooo-------ooo-----------------XXXXXXXXX----------XXXXXXXXXXXX---------XXXXXXXXXXXXXXX-------
S----------XXXXXXXXXXXXXXXX----r----------XXXXXXX---ooo-----yk--------r----XXXXXX-------XXXXXXXXXXXXXXXXXXXXXXXXXXXXXXX---------XXXXXXXXXXXXXXXXXXX--X
S----------XXXXXXXXXXXXXXXX--XXXXXX-------XXXXXXX-------XXXXXXXXXXXXXXXXXXXXXXXXXXX---XXXXXXXXXXXXXXXXXXXXXXXXXXXXXXXXX----XXXXXXXXXXXXXXXXXXXXXXXX--X
SXXXXXXXXXXXXXXXXXXXXXXXXXXXXXXXXXXXXXXXXXXXXXXXXXXXXXXXXXXXXXXXXXXXXXXXXXXXXXXXXXX---XXXXXXXXXXXXXXXXXXXXXXXXXXXXXXXXXXXXXXXXXXXXXXXXXXXXXXXXXXXXXXXX

