S----SSSSSSSSSSSSSSSSSSSSSSSSSSSSSSSSSSSSSSSSSSSSSSSSSSSSSSSSSSSSSSSSSSSSSSSSSSSSSSSSSSSSSSSSSSSSSSSSSSSSSSSSSSSSSSSSSSSSSSSSSSSSSSSSSSSSSSSSSSSSSSSSS
S-----------SSSSSSSS-------------SSSSSSSSSSSSSSSSSSSSSSSSSSSSSSSSSSSSSSSSSSSSSSSSSS--------SSSSSSSSSSSSSSSSSSSSSSSSSSSSSSSSSS-------SSSSSSSSSSS-------
S--------------------------------SSSSSSSSSSSSSSSSSSSSSSSS------------SSSSSSSSSSSSSS---------------------SSSSSS----------------------------SSSSS-------
S--------------------------------SSSSSS-------SSSSSSSSSSS--------------------SSSSSS-------------------------------------------------------SSSSS-------
S-----------------------------------------------------------------------------------------------------------------------------------------------------
S-----------------------------------------------------------------------------------------------------------------------------------------------------
S-----------------------------------------------------------------------------------------------------------------------------------------------------
S-----------------------------------------------------------------------------------------------------------------------------------------------------
S-----------------------------------oSS---------------------------------------------------------------------------------------------------------------
S-----------------------------------------------------------------------------------------------------------------------------------------------------
S-------------oSoSo-------ooo-----oooooo----------------------------------SSS-----ooo-----------------------------------------------------------------
S------------------------------------g------oooo------------------------------------------oooo----Sooo---oSooooo---------------------y-----oSooSoo----
S------------oooooooo---ooooo----XXXXXXXXXX------XXXXXX-------------------ooo---XXXXXX-------------------------------------oo------XXXXXX-------------
S----------------g-R-----k-------XXXXXXXXXX------XXXXXX------XXX----------------XXXXXX---ooooo-------------ooo----------------XXXXXXXXXXX----oo-------
SXXXXXXXXXXXXXXXXXXXXXXXXXXXXXXXXXXXXXXXXXX-yRg--XXXXXXXXX---XXX----XXXXXXXXXXXXXXXXXX---------------------g-----XXXXXXXXXXXXXXXXXXXXXXXX-----y-------
SXXXXXXXXXXXXXXXXXXXXXXXXXXXXXXXXXXXXXXXXXXXXXXXXXXXXXXXXXXXXXXXXXXXXXXXXXXXXXXXXXXXXXXXXXXXXXXXXXXXXXXXXXXXXXXXXXXXXXXXXXXXXXXXXXXXXXXXXXXXXXXXXXXXXX

