S----SSSSSSSSSSSSSSSSSSSSSSSSSSSSSSSSSSSSSSSSSSSSSSSSSSSSSSSSSSSSSSSSSSSSSSSSSSSSSSSSSSSSSSSSSSSSSSSSSSSSSSSSSSSSSSSSSSSSSSSSSSSSSSSSSSSSSSSSSSSSSSSSS
S----SSSSSSSS------SSSSSSSSSSSSSSSSSSSSS----------------------SSSSSSSSSSSSSSSSS---------------SSSSSSS-----SSSSS-----SSSSS-------SSSSSSSSSSSSSSSSSSSSSS
S----SSSSSSSS------SSSSSSSSSSSSSSSSSSSSS----------------------SSSSSS--------------------------SSSSSSS---------------------------SSSSS---------------SS
S----SSSSSSSS------SSSSSSSS---------------------------------------------------------------------------------------------------------------------------
S-----------------------------------------------------------------------------------------------------------------------------------------------------
S-----------------------------------------------------------------------------------------------------------------------------------------------------
S-----------------------------------------------------------------------------------------------------------------------------------------------------
S-----------------------------------------------------------------------------------------------------------------------------------------------------
S-------------------------------------------------------------oooo--------------------------Soo-------------------------------------ooSo--------------
S-----------------------------------------------------------------------------------------------------------------------------------------------------
S--------------------------------------------oSooo-------------ooo--------------------------oooo------------------------------------ooo---------------
S------------------------SoSoS----ooooooSS---------------------------oooo-----oooSo----------------------------------------------y---gy---------------
SXXXXXXXXXXXXXX------------------------------ooo-----------XXXXXXXXX----y----------------XXXXXXXX-------------------------------XXXXXXXXX-------XXXX--
SXXXXXXXXXXXXXX-----------ooo-----ooooooo------------------XXXXXXXXXXXXXXX----ooo--------XXXXXXXX---------XXXXXXXXXXX-----XXXX--XXXXXXXXXXX-----XXXX--
SXXXXXXXXXXXXXXXXXXXXX-Y-y-gg------r--------XXXXXXXXXXXXXXXXXXXXXXXXXXXXXX-----------XXXXXXXXXXXX---------XXXXXXXXXXXXXXXXXXXXXXXXXXXXXXXXX-----XXXX--
SXXXXXXXXXXXXXXXXXXXXXXXXXXXXXXXXXXXXXXXXXXXXXXXXXXXXXXXXXXXXXXXXXXXXXXXXXXXXXXXXXXXXXXXXXXXXXXXXXXX---XXXXXXXXXXXXXXXXXXXXXXXXXXXXXXXXXXXXXXXXXXXXX--

