S----SSSSSSSSSSSSSSSSSSSSSSSSSSSSSSSSSSSSSSSSSSSSSSSSSSSSSSSSSSSSSSSSSSSSSSSSSSSSSSSSSSSSSSSSSSSSSSSSSSSSSSSSSSSSSSSSSSSSSSSSSSSSSSSSSSSSSSSSSSSSSSSSS
S----SSSSSSSSSSSSSSSSSS-------SSSSSSSSSSSSSSSSSSSSSSSSSSSSSSSSSSSSSSSSSSSSSSSSSSSSSSSSSSSSSSSSSSSSSSSSSSSSSSSSSS------------SSSSSSSSSSSSSSSSSSSSSS----
S----SSSSSSSSSSSSS------------SSSSSS-------SSSSSSS------SSSSSSSSSSSSSSSSSSSSSSSSSS--------SSSSSS-----SSSSSS---------------------------------SSSSSS----
S----SSSSSSSSSSSSS------------SSSSSS-------SSSSSSS-----------SSSSSSSSSSSSSSSSSSSSS----------------------------------------------------------SSSSSS----
S-----------------------------------------------------------------------------------------------------------------------------------------------------
S-----------------------------------------------------------------------------------------------------------------------------------------------------
S-----------------------------------------------------------------------------------------------------------------------------------------------------
S-----------------------------------------------------------------------------------------------------------------------------------------------------
S------------ooo--------------------------------------------------------------------------------------------------------------------------------------
S-------------------------------------------------------oSooSoo---------------------------------------------------------------------------------------
S-----------ooo----Tt--tt----tt---tt----------ooooo---------------------------------------oooooo------------------------------------------------------
S--------------k---Tt--tt----tt---tt----Tt------y---------oooo------Tt--------oSoooooo-----------------------------------------------ooSo-------------
SXXXXXXXXXXXXXXXXXXXXXXXXXXXXXXX--tt----Tt---XXXXXXXXX---y----------Tt---XXXX------------XXXXXXXXXXXX--------------XXXXXXXX-----------------------XXXX
SXXXXXXXXXXXXXXXXXXXXXXXXXXXXXXXXXXXXXXXXXXXXXXXXXXXXXXXXXXXXXXXXXXXXXXXXXXXX--ooooo---XXXXXXXXXXXXXX--------------XXXXXXXX-------XX-ooooo--XXX---XXXX
SXXXXXXXXXXXXXXXXXXXXXXXXXXXXXXXXXXXXXXXXXXXXXXXXXXXXXXXXXXXXXXXXXXXXXXXXXXXX-----k-k--XXXXXXXXXXXXXXXXXX--------XXXXXXXXXX-------XX--------XXX---XXXX
SXXXXXXXXXXXXXXXXXXXXXXXXXXXXXXXXXXXXXXXXXXXXXXXXXXXXXXXXXXXXXXXXXXXXXXXXXXXXXXXXXXXXXXXXXXXXXXXXXXXXXXXXXXX--XXXXXXXXXXXXXXX---XXXXXXXXXXXXXXXXXXXXXX

