S----SSSSSSSSSSSSSSSSSSSSSSSSSSSSSSSSSSSSSSSSSSSSSSSSSSSSSSSSSSSSSSSSSSSSSSSSSSSSSSSSSSSSSSSSSSSSSSSSSSSSSSSSSSSSSSSSSSSSSSSSSSSSSSSSSSSSSSSSSSSSSSSSS
S----SSSSSSSSSSSSS-----SSSSSSSS------SSSSSSSSSSSSSSS--------------SSSSS--------SSSSS-----SSSSSSSSSSSSSSSSSSSSSSSSSSSSS-------SSSSSSSSSSSSSSSSSS-------
S------------------------------------SSSSSSSS---------------------SSSSS--------SSSSS-----SSSSSSSS-----SSSSSSSSSSSSSSSS-------SSSSSSSSSSSSSSSSSS-------
S----------------------------------------------------------------------------------------SSSSSSSS----------SSSSS-------------SSSSSSS-----SSSSSS-------
S-----------------------------------------------------------------------------------------------------------------------------------------------------
S-----------------------------------------------------------------------------------------------------------------------------------------------------
S-----------------------------------------------------------------------------------------------------------------------------------------------------
S-----------------------------------------------------------------------------------------------------------------------------------------------------
S-----------------------------------------------------------------------------------------------------------------------------------------------------
S-----------------------------------------------------------------------------------------------------------------------------------------------SoSo--
S-----------oooooSS-----------------------------------------------------------------ooooo----------------------------oSooo-----------oooo-------------
S------------------------------------oSooSo-------------oooooo--ooooo---oSoooo----------------------SooSS-----------------------------r--------ooo----
SXXXXXXXXX----oooo----------------------------------------------y----------------ooooooooo----------------------------oooo-------XXXXXXXXXXX---r------
SXXXXXXXXX------y--------------------ooo----XXXXXXXXXXX----oo--XXXXXXXX----oo----y-------k----------oooooo-----------------y-----XXXXXXXXXXXXXXXXXXXXX
SXXXXXXXXXXXXXXXXXXXX------XXXX-------------XXXXXXXXXXX--------XXXXXXXX---------XXXXXXXXXXX--r--------------XXXXXXXXXXXXXXXXX----XXXXXXXXXXXXXXXXXXXXX
SXXXXXXXXXXXXXXXXXXXXXXXXXXXXXXXXXXXXXXXXXXXXXXXXXXXXXXXXXXXXXXXXXXXXXXXXXXXXXXXXXXXXXXXXXXXXXXXXXXXXXXXXXXXXXXXXXXXXXXXXXXXXXXXXXXXXXXXXXXXXXXXXXXXXX

