S----SSSSSSSSSSSSSSSSSSSSSSSSSSSSSSSSSSSSSSSSSSSSSSSSSSSSSSSSSSSSSSSSSSSSSSSSSSSSSSSSSSSSSSSSSSSSSSSSSSSSSSSSSSSSSSSSSSSSSSSSSSSSSSSSSSSSSSSSSSSSSSSSS
S---------SSSSSSSS------SSSSSSSSSSSSSSSSSSSSSSSSSSSSSSSSSSSSSSSSSSSSSSSSSSSSSSSSSSSSSSSSSSSSSSSSSSSSSSSSSS-------------------SSSSSSSSSSSSSSSSSSSSSSSSS
S-----------------------SSSSSSSSSSSSSSSSSSSSSS------SSSSSSS--------------SSSSSSSSSSSSS-------SSSSS---------------------------SSSSSSSSSSSS-------SSSSSS
S------------------------------SSSSSSS-----------------------------------SSSSS---------------SSSSS--------------------------------SSSSSSS-------------
S-----------------------------------------------------------------------------------------------------------------------------------------------------
S-----------------------------------------------------------------------------------------------------------------------------------------------------
S-----------------------------------------------------------------------------------------------------------------------------------------------------
S-----------------------------------------------------------------------------------------------------------------------------------------------------
S---------------------------------------------------------------------ooo-------------------------------------------------------------SoSoo-----------
S-----------------------------------------------------------------------------oSoSS-------------------------------------------------------------------
S--------------------SooS---------ooSo-----------------------SSoS---oooooo--------------ooo-----ooo------------------------------------oooooo---------
S------------------------------------------------ooooo-------------------------oo---------------------------------------------------------------------
S-------------------oooooo--------ooo-----oooo---k----r------ooooo-XXXXXXXXXX--------XXXXXXXX----oo----------------XXX--------------XXXXXXXXXX--------
S---------------------------XXXXX----r----------XXXXXXXXX--r---k---XXXXXXXXXXXXXXXXXXXXXXXXXX---------oooo---XXXXXXXXXXXX--------XXXXXXXXXXXXX--------
SXXXXXXXXXXXXX----XXXXXXXXXXXXXXXXXXXXXXXXXXXXXXXXXXXXXXXXXXXXXXXXXXXXXXXXXXXXXXXXXXXXXXXXXXXXXXXXXX------kr-XXXXXXXXXXXX------XXXXXXXXXXXXXXXXXXXXXXX
SXXXXXXXXXXXXXXXXXXXXXXXXXXXXXXXXXXXXXXXXXXXXXXXXXXXXXXXXXXXXXXXXXXXXXXXXXXXXXXXXXXXXXXXXXXXXXXXXXXXXXXXXXXXXXXXXXXXXXXXXXXXXXXXXXXXXXXXXXXXXXXXXXXXXX

