S----SSSSSSSSSSSSSSSSSSSSSSSSSSSSSSSSSSSSSSSSSSSSSSSSSSSSSSSSSSSSSSSSSSSSSSSSSSSSSSSSSSSSSSSSSSSSSSSSSSSSSSSSSSSSSSSSSSSSSSSSSSSSSSSSSSSSSSSSSSSSSSSSS
S----SSSSSSSSSSSSSSSSSSSSSSSSSSSSSSSSSSSSSSSSSSSSSSSSSSSSSSSSSSSSSSSSSSSSSSSSSSSSSSSSSSSSSSSSSSSSSS--------SSSSSSSSSSSS---------------SSSSSSSSSSSSSSSS
S----SSSSSSS-----SSSSSSSS------SSSSSSSSSSSSSSSSSSSSSSSSSSSSSSSSSSSSSSSSSSSSSSSSSSSSSSSSSSSSSSSSSSSS--------SSSSSSSSSSSS-----------------------SSSSSSS-
S----SSSSSSS--------------------------SSSSSSSSSSSSSSSSSSSSSSSSSSSSSS----------SSSSSSS--------SSSSSS---------------------------------------------------
S-----------------------------------------------------------------------------------------------------------------------------------------------------
S-----------------------------------------------------------------------------------------------------------------------------------------------------
S-----------------------------------------------------------------------------------------------------------------------------------------------------
S-----------------------------------------------------------------------------------------------------------------------------------------------------
S-----------------------------------------------------------------------------------------------------------------------------------------------------
S---------------------------------------------------------SoSooSo-------------------------------------------------------------------------------------
S-------------------------------ooSo----------------------------------ooooo-------oooS----------------------------------------------------------------
S------------------------Sooo--------------ooSoo-----------ooooo------------------------------------------------------------oSSoo---------------------
S---------------------------------oooo-------------------k-----------XXXXXXX-----oooooooo------------------------XXXXXXXX-----------oo----------------
S-----------------------oooooo--------y--ooooooo--------XXXXXXXXXXX--XXXXXXX-----k--------------------------XXXXXXXXXXXXX-ooooo---------R-XXX---XXXXXX
SXXXXXXXXXXXX------------------XXXXXXXXX----------------XXXXXXXXXXXXXXXXXXXX----XXXXXXXXXX----XXX-----------XXXXXXXXXXXXX-------y--XXXXXXXXXX---XXXXXX
SXXXXXXXXXXXXXXXXXXXXXXXXXXXXXXXXXXXXXXXXXXXXXXXXXXXXXXXXXXXXXXXXXXXXXXXXXXXXXXXXXXXXXXXXXXXXXXXXXXXXXXXXXXXXXXXXXXXXXXXXXXXXXXXXXXXXXXXXXXXX---XXXXXX

