S----SSSSSSSSSSSSSSSSSSSSSSSSSSSSSSSSSSSSSSSSSSSSSSSSSSSSSSSSSSSSSSSSSSSSSSSSSSSSSSSSSSSSSSSSSSSSSSSSSSSSSSSSSSSSSSSSSSSSSSSSSSSSSSSSSSSSSSSSSSSSSSSSS
S----SSSSSSSSSSSSSSSSSSSSSSSSSSSSSSSSSSS------------SSSSSSSSSSSSSSSSSSSSSSSSSSSSSSSS-----SSSSSSSSSSSSSSSSSSSSSSSSSSSSSSSSSSSSSSSSSSSSSSSSSSSSS--------
S----SSSSSSSSSSSSSSSSSSSSSSSSSSSS-------------------SSSSSS-------------SSSSSSSSSSSSS-----SSSSSSSSSS------SSSSSSSSSSSSSSSS------SSSSSSSSSSSSSSS--------
S----SSSSSSSSSSSSSSSSS------------------------------SSSSSS-------------SSSSSSS-----------SSSSSSSSSS------SSSSSSSS--------------SSSSSSSSSSSSSSS--------
S-----------------------------------------------------------------------------------------------------------------------------------------------------
S-----------------------------------------------------------------------------------------------------------------------------------------------------
S-----------------------------------------------------------------------------------------------------------------------------------------------------
S-----------------------------------------------------------------------------------------------------------------------------------------------------
S--------------oSSo--------------------------------------------------------oSSSoooo---------------------------------------------ooooSooo--------------
S---------------------------------------------------------Sooo---oSooo--------------------------------------------------------------------------------
S----------------oo------------------oSS------------------------------------ooooo-----oSSo-----------------------oSoo------------oooooo---oo----------
S----------------------ooooSoSS---------------------------------oooooooo--------------------------------------------------------------------k---------
S------------XXXXXXXXX---------------------------ooo----------------------XXXXXXXXXXX-oooooo-XXXXXXXXX-ooooo-------------------XXXXXXXXXXXXXXXXX------
S------------XXXXXXXXX-ooooooooo------------------------XXXXXXXXXXXXXXXXXXXXXXXXXXXXX----k-k-XXXXXXXXX-----k----------XXXX-----XXXXXXXXXXXXXXXXX------
SXXXXXXXXXXXXXXXXXXXXX--------k--XXXXXXXXXXXXXXXXXXXXXXXXXXXXXXXXXXXXXXXXXXXXXXXXXXXXXXXXXXXXXXXXXXXXXXXXXXXXXXXXXXXXXXXXX-----XXXXXXXXXXXXXXXXXXXXXXX
SXXXXXXXXXXXXXXXXXXXXXXXXXXXXXXXXXXXXXXXXXXXXXXXXXXXXXXXXXXXXXXXXXXXXXXXXXXXXXXXXXXXXXXXXXXXXXXXXXXXXXXXXXXXXXXXXXXXXXXXXXXXXXXXXXXXXXXXXXXXXXXXXXXXXX

