S----SSSSSSSSSSSSSSSSSSSSSSSSSSSSSSSSSSSSSSSSSSSSSSSSSSSSSSSSSSSSSSSSSSSSSSSSSSSSSSSSSSSSSSSSSSSSSSSSSSSSSSSSSSSSSSSSSSSSSSSSSSSSSSSSSSSSSSSSSSSSSSSSS
S------------SSSSSSSS--------SSSSSSSSSSSSSSSSSSSSSSSSSSSSSSSSSSSSSSSSSSSSSSSSSSSSSSSSSSSSSSSSSSSSSSSSSSSSSSSSSSSSSSSSSSSSSSSSSSSSSSSSSSSSSSSS-----SSSS
S------------SSSSSSSS--------SSSSSSSSSSSSSSSSSSSSS-------SSSSSSSSSSSSSSSSSS------SSSSSSSSSSSSSSSSSSSSSSS-----SSSSSSSSSSS--------------------------SSSS
S-----------------------------------SSSSSSSSSSSSSS------------SSSSSSS------------SSSSSSSS-------SSSSSSSS----------------------------------------------
S-----------------------------------------------------------------------------------------------------------------------------------------------------
S-----------------------------------------------------------------------------------------------------------------------------------------------------
S-----------------------------------------------------------------------------------------------------------------------------------------------------
S-----------------------------------------------------------------------------------------------------------------------------------------------------
S---------------SoSSSSo-------------------------------------------------------------------------------------------------------------------------------
S------------------------------oooooS-------------oooSoo----------------------------------------------------------------------------------------------
S---------------oooo------------------------------------------------------------------------------------ooooo----------ooo-------------------------tt-
S---------------r--------------ooooooo------ooo---ooooooo----ooo-------ooSo-----------------------------------------------------oSoooo-------------tt-
S-------------XXXXXXXXXX------------k-------------------------y--------------------------------------ooooooo------------oooo---------------XXXXXX--tt-
SXXXXXXXXXXXXXXXXXXXXXXX------XXXXXXXXXXX-------XXXXXXXXXXXXXXXXXXX-ooooo----------XXXXX--XXXXX--------r------XX--XX------------oooooo--XXXXXXXXXXXXXX
SXXXXXXXXXXXXXXXXXXXXXXXXXXXXXXXXXXXXXXXX-------XXXXXXXXXXXXXXXXXXX---------XXXXXXXXXXXX--XXXXX-----XXXXXXXXXXXX--XXXXXXXXXXXX--------r-XXXXXXXXXXXXXX
SXXXXXXXXXXXXXXXXXXXXXXXXXXXXXXXXXXXXXXXXXXXXXXXXXXXXXXXXXXXXXXXXXXXXXXXXXXXXXXXXXXXXXXX--XXXXXXXXXXXXXXXXXXXXXX--XXXXXXXXXXXXXXXXXXXXXXXXXXXXXXXXXXXX

