S----SSSSSSSSSSSSSSSSSSSSSSSSSSSSSSSSSSSSSSSSSSSSSSSSSSSSSSSSSSSSSSSSSSSSSSSSSSSSSSSSSSSSSSSSSSSSSSSSSSSSSSSSSSSSSSSSSSSSSSSSSSSSSSSSSSSSSSSSSSSSSSSSS
S----SSSSSSSSSSSSSSSSSSSSSSSSSS-----SSSSSSSS-----SSSSSSSSSSSSSSSSSSSSSSSSSSSSSSSSSSSSSSSSSSSSSSSSSSSSSSSSSS-------------------SSSSSSS--------------SSS
S----SSSSS--------SSSSSSSSSSSSS-----SSSSSSSS-----SSSSSSSSSSSSSSSSSSSSSSSSSSSSSSSSSSSSSSSSSSSSSSSSSSSSSSSSSS-------------------SSSSSSS--------------SSS
S-----------------SSSSSSS-----------------------------SSSSSSSS--------------SSSSS-----SSSSSSSSSSSSS---------------------------SSSSSSS-----------------
S-----------------------------------------------------------------------------------------------------------------------------------------------------
S-----------------------------------------------------------------------------------------------------------------------------------------------------
S-----------------------------------------------------------------------------------------------------------------------------------------------------
S-----------------------------------------------------------------------------------------------------------------------------------------------------
S------------------------------------------------------------oooo-------------------------------------------------------------------------------------
S----------------------------------------SSoSo----Soooooo-----------------------------ooSS------------------------------------------------------------
S-------------------------------ooooo-----------------------ooo----------------------------------------------------------------------------------oooo-
S-------------oSSo---oSSo----------------oo-----oooooooo------------------------------ooo---------ooo-----ooSo----------------------------------------
SXXXXXXXXXX-------------------ooooo--------------k----y---XXXXXXXX--------------XXXX--y----------r-----------------------------ooooo---------XXXXXXXXX
SXXXXXXXXXX---ooo------ooo---------k--XXXXXXXXXXXXXXXXXXXXXXXXXXXX------XXXXX---XXXXXXXXXXXXXXXXXXXXXX-----ooo--XXXXXXX-----------------XXXXXXXXXXXXXX
SXXXXXXXXXX--------------r-Y-XXXXXXXXXXXXXXXXXXXXXXXXXXXXXXXXXXXXXXXXXXXXXXXX---XXXXXXXXXXXXXXXXXXXXXXXX--------XXXXXXX--y----XXXXXXX---XXXXXXXXXXXXXX
SXXXXXXXXXXXXXXXXXXXXXXXXXXXXXXXXXXXXXXXXXXXXXXXXXXXXXXXXXXXXXXXXXXXXXXXXXXXXXXXXXXXXXXXXXXXXXXXXXXXXXXXXXXXXXXXXXXXXXXXXXXXXXXXXXXXXXXXXXXXXXXXXXXXXX

