S----SSSSSSSSSSSSSSSSSSSSSSSSSSSSSSSSSSSSSSSSSSSSSSSSSSSSSSSSSSSSSSSSSSSSSSSSSSSSSSSSSSSSSSSSSSSSSSSSSSSSSSSSSSSSSSSSSSSSSSSSSSSSSSSSSSSSSSSSSSSSSSSSS
S----SSSSSSSSSSSSSSSSSSSSSSSSSSSSSSSSSSSSSSSSSSSSSSSSSSSSSSSSSSSSSSSSSSSSSSSSSSSSSSSSSSSSSSSSSSSSSSSSSSSSSSSSSSS-------SSSSS-------SSSSSSSSSSSSSSSSSSS
S----SSSSSSSSSSSSSS------------SSSSSSSSSSSSSSSSSSSSSSSSSSSSSSSS-------SSSSSSSSSSSSS------SSSSSS------------SSSSS-------SSSSS-------SSSSSSSSSSSSSSSSSSS
S----SSSSSSSS------------------SSSSSS-----SSSSSS----------------------SSSSSS-------------------------------SSSSS-------------------SSSSS--------------
S-----------------------------------------------------------------------------------------------------------------------------------------------------
S-----------------------------------------------------------------------------------------------------------------------------------------------------
S-----------------------------------------------------------------------------------------------------------------------------------------------------
S-----------------------------------------------------------------------------------------------------------------------------------------------------
S--------------------------------oSSo------------------------------------------------------------------------oooooS-----------------------------------
S-------------------------------------------------------------------------------------SSoooo----------------------------------------------------------
S----------------------------------oooo-----------------------------------------------------------------------oooooooo------SoSoS---------------------
S------------------------------------------------------------------SooSo------------oooooooo--------------------------------------------ooooo---------
SXXXXXXXXXXXXX-----------------XXXXXXXXXX-------XXXXX-----y-----------------------------------y-------------XXXXXXXXXXXXX--oooooo---------------------
SXXXXXXXXXXXXX-----------------XXXXXXXXXX-------XXXXX--XXXXXX----oooooooo-XXXXXXXXXXXXXXXXXXXXXXXXX---------XXXXXXXXXXXXX--y---------oooooo---XX------
SXXXXXXXXXXXXXXXXXX-------XXXXXXXXXXXXXXX-------XXXXX--XXXXXXXX-----------XXXXXXXXXXXXXXXXXXXXXXXXXXXXXXXXXXXXXXXXXXXXXXXXXXXXXXXXXX----------XX-y----
SXXXXXXXXXXXXXXXXXXXXXXXXXXXXXXXXXXXXXXXXXXXXXXXXXXXXXXXXXXXXXXXXXXXXXXXXXXXXXXXXXXXXXXXXXXXXXXXXXXXXXXXXXXXXXXXXXXXXXXXXXXXXXXXXXXXXXXXXXXXXXXXXXXXXX

