S----SSSSSSSSSSSSSSSSSSSSSSSSSSSSSSSSSSSSSSSSSSSSSSSSSSSSSSSSSSSSSSSSSSSSSSSSSSSSSSSSSSSSSSSSSSSSSSSSSSSSSSSSSSSSSSSSSSSSSSSSSSSSSSSSSSSSSSSSSSSSSSSSS
S----SSSSSSSSSSSSSSSSSSSSSSSSSSSSSSSSSSSSSSSSSSSSSSSSSSSSSSSSSSSSSSSSSS-------SSSSSSSSSSSSSSSSSSSSS-------SSSSSSSS--------SSSSSSSSSSSSSSSSSSSSSSSSSS--
S----SSSSSS------SSSSSSSSSSSSSSSSS---------------------SSSSS------------------SSSSSSSS--------SSSSS-----------------------SSSSSSSSSSSS----------------
S----SSSSSS------SSSSSSSSSSSSSSSSS--------------------------------------------SSSSSSSS------------------------------------SSSSSSSSSSSS----------------
S-----------------------------------------------------------------------------------------------------------------------------------------------------
S-----------------------------------------------------------------------------------------------------------------------------------------------------
S-----------------------------------------------------------------------------------------------------------------------------------------------------
S-----------------------------------------------------------------------------------------------------------------------------------------------------
S----------------------------------------------------SSoooo-------------------------------------------------------------------------------------------
S-------------------------SSSooS-----------------------------------------------------------------------oSoo-------------------------------------------
S--------------oooooo--------------ooo-------------ooooo-------------------------------------------------------------------------------------ooooo----
S-------------------------ooooooo-------------------y---r----------------------------------------------ooooo-------oo---------------------------------
S------------XXXXXXXXXX-------------------ooooo---XXXXXXXXXX-------------yy-----ooo------------------------r---------------------------------oooo--XXX
SXXXXXXXXXXXXXXXXXXXXXXXXXXXXXXXXX----------------XXXXXXXXXX----------XXXXXX--------------------------XXXXXXXXXXXXXXXX---ooo---XXX----oo-----k-----XXX
SXXXXXXXXXXXXXXXXXXXXXXXXXXXXXXXXXXXXXXXXXXXXXXXXXXXXXXXXXXXXXXXXXXXXXXXXXXXXXXXXXXX------------------XXXXXXXXXXXXXXXX------r--XXXXX--------XXXXXXXXXX
SXXXXXXXXXXXXXXXXXXXXXXXXXXXXXXXXXXXXXXXXXXXXXXXXXXXXXXXXXXXXXXXXXXXXXXXXXXXXXXXXXXXXX--XXXXXXXXXXXXXXXXXXXXXXXXXXXXXXXXXXXXXXXXXXXXXXXXXXXXXXXXXXXXXX

