S----SSSSSSSSSSSSSSSSSSSSSSSSSSSSSSSSSSSSSSSSSSSSSSSSSSSSSSSSSSSSSSSSSSSSSSSSSSSSSSSSSSSSSSSSSSSSSSSSSSSSSSSSSSSSSSSSSSSSSSSSSSSSSSSSSSSSSSSSSSSSSSSSS
S----SSSSSSSSSSSSSSSSSSSS-----SSSSSSSSSSSSSSSSSSSSSSSSSSSSSSSSSSSSSSSSSSSSSSSSSSSSSSSSSSSSSSSSSSSSSSSSSSSSSSSSSSSSSSSSSSSSSSSSSSSSSSSS-------------SSS
S----SSSSSSSSSSSSSSSSSSSS------------SSSSSSSSSSSSS-------------SSSSSS-------SSSSSSSSSSSSSSSSSSSSSSSSSSS-------------SSSSSSSSSSSSSSSSSS----------------
S----------SSSSSS--------------------SSSSSSSSSSSSS--------------------------SSSSSSSSSSSSSSS-------SSSSS---------------------SSSSS---------------------
S-----------------------------------------------------------------------------------------------------------------------------------------------------
S-----------------------------------------------------------------------------------------------------------------------------------------------------
S-----------------------------------------------------------------------------------------------------------------------------------------------------
S-----------------------------------------------------------------------------------------------------------------------------------------------------
S-----------------------------------------------------------------------------------SoSSo-----------------------------------------------------ooSooo--
S-----------------------------------------oooo-----------------------------------------------------------oSooo-------ooo----------Soooo---------------
S-----------------------------oooooSo------------oooooo-----------------------ooo---ooooo-----------------------------------------------------ooooooo-
S------------------oSSSo-----------------------------------------------------------y-----k---------------oooo---------------------oo------------------
S---------------------------ooooooo--------Y-------ooooo---------------k------oo--XXXXXXXXX-----------------------y------XXXXXX------------XXXXXXXXXXX
S------------------oooooo-------------XXXXXXXXX------------oooo------XXXXXX-------XXXXXXXXX-----XXX-----XXXXXXXXXXXXXXXXXXXXXXXXXXXXXXXX---XXXXXXXXXXX
SXXXXXXXXXXXXXXXXX---------XXXXXXXXXXXXXXXXXXXXXXXXXXXXXXX----ry-----XXXXXXXXXXXXXXXXXXXXXXXXXXXXXXXXXXXXXXXXXXXXXXXXXXXXXXXXXXXXXXXXXXX---XXXXXXXXXXX
SXXXXXXXXXXXXXXXXXXXXXXXXXXXXXXXXXXXXXXXXXXXXXXXXXXXXXXXXXXXXXXXXXXXXXXXXXXXXXXXXXXXXXXXXXXXXXXXXXXXXXXXXXXXXXXXXXXXXXXXXXXXXXXXXXXXXXXXXXXXXXXXXXXXXX

