S----SSSSSSSSSSSSSSSSSSSSSSSSSSSSSSSSSSSSSSSSSSSSSSSSSSSSSSSSSSSSSSSSSSSSSSSSSSSSSSSSSSSSSSSSSSSSSSSSSSSSSSSSSSSSSSSSSSSSSSSSSSSSSSSSSSSSSSSSSSSSSSSSS
S----SSSSS------SSSSSSSSSSSSSSSSSSSSSSSSSSSSSSSSSSSSSSSSSSSSSSSSSSSSSSSSSSSSSSSS-----SSSSSSS-------SSSSSSSSSSSSSSSSSSSSSSSSSSSSSSSSSSSSSSSSSSSS-------
S----SSSSS------SSSSSSSSSSSSSSS----------------SSSSSSSSSSSSSSSSSSSSSSSSS-------------SSSSSSS-------SSSSSSSSSSSS--------SSSSSSSSSSS-------SSSSSS-------
S----------------------------------------------SSSSSSS-----SSSSSS--------------------SSSSSSS------------SSSSSSS---------------------------------------
S-----------------------------------------------------------------------------------------------------------------------------------------------------
S-----------------------------------------------------------------------------------------------------------------------------------------------------
S-----------------------------------------------------------------------------------------------------------------------------------------------------
S-----------------------------------------------------------------------------------------------------------------------------------------------------
S--------------------------------------------------------------------ooS------------------------------------------------------------------------------
S------------------------------------------------------------------------------------------ooS--------------------------------------------------------
S----------------------ooooo------------oSo----oooo------------------oooo---------------------------oSooSoSo------------------------------------------
S----------------------------------------------------------------------r----------------------------------------------------------oSooSo-------oooSo--
S----------------tt----ooooooo--------ooooo--XXXXXXXXXXXX--------XXXXXXXXXX----------------y--r--------ooooo--------Tt---------XX---------------------
S-------------tt-tt------r--k----------------XXXXXXXXXXXX--------XXXXXXXXXXXX----ooo-----XXXXXXX-------r--y-----Tt--Tt--tt-XXXXXX--ooo----------oo----
SXXXXXXXXXXX--tt-tt---XXXXXXXXXXXXXXXXXXXXXXXXXXXXXXXXXXX--------XXXXXXXXXXXX--k---------XXXXXXX---XXXXXXXXXX---Tt--Tt--tt-XXXXXX---------XXX---------
SXXXXXXXXXXXXXXXXXXXXXXXXXXXXXXXXXXXXXXXXXXXXXXXXXXXXXXXXXXXXXXXXXXXXXXXXXXXXXXXXXXXXXXXXXXXXXXXXXXXXXXXXXXXXXXXXXXXXXXXXXXXXXXXXXXXXXXXXXXXXXXXXXXXXX

