S----SSSSSSSSSSSSSSSSSSSSSSSSSSSSSSSSSSSSSSSSSSSSSSSSSSSSSSSSSSSSSSSSSSSSSSSSSSSSSSSSSSSSSSSSSSSSSSSSSSSSSSSSSSSSSSSSSSSSSSSSSSSSSSSSSSSSSSSSSSSSSSSSS
S----SSSSSSSSSSSSS------SSSSSSSSSSSSSSSSSSSSSSSSSSSSSSSSSSSSSSSSSSSSS-----SSSSS--------SSSSSSSSSSSSSSSSSSS-------SSSSSSSSSSSSSSSSSSSS--------SSSSSSSSS
S------------------------------SSSSSS-------SSSSSSSSSSSSS-----SSSSSSS------------------SSSSSSS-------SSSSS-------SSSSSSSSSSSS----------------SSSSSSSSS
S--------------------------------------------------------------------------------------SSSSSSS-----------------------------------------------SSSSSSSS-
S-----------------------------------------------------------------------------------------------------------------------------------------------------
S-----------------------------------------------------------------------------------------------------------------------------------------------------
S-----------------------------------------------------------------------------------------------------------------------------------------------------
S-----------------------------------------------------------------------------------------------------------------------------------------------------
S--------------------------------------------------------------------------------------------------------oooSSS---------------------Soooo-------------
S-----------------------------------------------------------------------------------------------------------------------------------------------------
S--------------------------ooooooo----------------SSo---oSooSooo--oSSSSSoS---------oSo-------------------oooooo------oooo----------oooooo-------------
S-----------SSS----------------r----------------------------------------------------------ooooooS-----------y------------r-----------y--------R-------
SXXXXXXXXX------------XXXXXXXXXXXXXX--------------ooo------oooo---ooooooooo--------ooooo----------------XXXXXXXXXXXXXXXXXXX-----XXXXXXXXXXXXXXXXXX----
SXXXXXXXXX-oooooo-----XXXXXXXXXXXXXXXXXXXXXXXX--ryr-----------------------Y-XXXXXX----y-----ooooo-------XXXXXXXXXXXXXXXXXXX-----XXXXXXXXXXXXXXXXXXXXXX
SXXXXXXXXX---------XXXXXXXXXXXXXXXXXXXXXXXXXXXXXXXXXXXXXXXXXXXXXXXXXXXXXXXXXXXXXXXXXXXXXX--R--r-r---XXXXXXXXXXXXXXXXXXXXXXXXXXXXXXXXXXXXXXXXXXXXXXXXXX
SXXXXXXXXXXXXXXXXXXXXXXXXXXXXXXXXXXXXXXXXXXXXXXXXXXXXXXXXXXXXXXXXXXXXXXXXXXXXXXXXXXXXXXXXXXXXXXXXXXXXXXXXXXXXXXXXXXXXXXXXXXXXXXXXXXXXXXXXXXXXXXXXXXXXX

