S----SSSSSSSSSSSSSSSSSSSSSSSSSSSSSSSSSSSSSSSSSSSSSSSSSSSSSSSSSSSSSSSSSSSSSSSSSSSSSSSSSSSSSSSSSSSSSSSSSSSSSSSSSSSSSSSSSSSSSSSSSSSSSSSSSSSSSSSSSSSSSSSSS
S----SSSSSSSSSSSSSS-------SSSSS-------------------SSSSSSSSSSSSSSSSSSSSSSSSSSSSSSSSSSSSSSSSSSSSSSSSSSSSSSSSSSSSSSSSS-----------------SSSSSSSSSSSSSSSSSS
S----SSSSSSSSSSSSSS-------------------------------SSSSSSSSSSSSSSSSSSSSSSSSSSSSS-------------SSSSSSSSSSSSSSSSSSSSSSS-----------------SSSSSSSSSSSS-----S
S----SSSSSSS---------------------------------------------------SSSSSSSSSSSSSSSS-------------------------SSSSSS----------------------------------------
S-----------------------------------------------------------------------------------------------------------------------------------------------------
S-----------------------------------------------------------------------------------------------------------------------------------------------------
S-----------------------------------------------------------------------------------------------------------------------------------------------------
S-----------------------------------------------------------------------------------------------------------------------------------------------------
S------------------------------------------------ooSSooSoo-------------oooSoSo---------------------------------oSo------------------------------------
S------------------------tt------------------------------------------------------------------------ooo-----------------SoSooo-------------------------
S------------------------tt----tt-----------------oooooooo----------------ooooo-------------ooo----------------ooo------------------------------------
S------------------------tt----tt----------------------------ooo--------------------------------------------------------oooooo---ooooSSS-----oSSS-----
SXXXXXXXXXXX--tt-------XXXXXXXXXXXX-------------XXXXXXXXXXX-----------XXXXXXXXXXX----------XXXXXX-------XXXXXXXXXXXXX-----y---------------------------
SXXXXXXXXXXX--tt----XXXXXXXXXXXXXXX-------------XXXXXXXXXXXXXXXXXX----XXXXXXXXXXX-----XXXXXXXXXXXXXXXXXXXXXXXXXXXXXXXXXXXXXXXXXX---oooooo---ooooo-----
SXXXXXXXXXXXXXXXXXXXXXXXXXXXXXXXXXX--X---X--XXXXXXXXXXXXXXXXXXXXXX----XXXXXXXXXXX-----XXXXXXXXXXXXXXXXXXXXXXXXXXXXXXXXXXXXXXXXXX-------y--------k--XXX
SXXXXXXXXXXXXXXXXXXXXXXXXXXXXXXXXXXXXX---XXXXXXXXXXXXXXXXXXXXXXXXXXXXXXXXXXXXXXXXXXXXXXXXXXXXXXXXXXXXXXXXXXXXXXXXXXXXXXXXXXXXXXXXXXXXXXXXXXXXXXXXXXXXX

