S----SSSSSSSSSSSSSSSSSSSSSSSSSSSSSSSSSSSSSSSSSSSSSSSSSSSSSSSSSSSSSSSSSSSSSSSSSSSSSSSSSSSSSSSSSSSSSSSSSSSSSSSSSSSSSSSSSSSSSSSSSSSSSSSSSSSSSSSSSSSSSSSSS
S----SSSSSSSSSSSSSSSSSSSSSSSSSSSSSSSSSSSSSSSSSSSSSSSSSSSSSSSSSSSS-------SSSSSSSSSSSSSSSSSSS--------SSSSSSSSSSSSSSSSSSSSSSSSSSSSSSSSSSSSSSSSS--------SS
S-----------SSSSS-----SSSSSSS-----SSSSSSSSSSSSSSSSS----------------------------SSSSSSSSSSSS--------SSSSSSSS------------SSSSSS--------SSSSSSS--------SS
S---------------------SSSSSSS-----------SSSSSS-------------------------------------------------------------------------SSSSSS-----------------------SS
S-----------------------------------------------------------------------------------------------------------------------------------------------------
S-----------------------------------------------------------------------------------------------------------------------------------------------------
S-----------------------------------------------------------------------------------------------------------------------------------------------------
S-----------------------------------------------------------------------------------------------------------------------------------------------------
S----------oooSS--------------------------------------------------------------------------------------------------------------------------------------
S------------------------------------------------------------------------------------SoooSooo--------oSSooSSo-----------------------------------------
S------------ooooo--------------------ooo---------------------ooSoSoS---------------------------------------------------oooSoo------------------------
S------------------------Tt-tt-tt------------------------------------------SSooo-------oooooo---------ooooooo-----------------------------------------
S---------XXXXXXXXXX-----Tt-tt-tt--XXXXXXX-------XXXXXXXXXXXX--ooooooo--------------r-------------XX----------------------ooo-------oo----------------
SXXXXXXXXXXXXXXXXXXXXXX--Tt-tt-tt--XXXXXXX-oooo--XXXXXXXXXXXX--y-----------ooooooo-XXXXXXXXXXX----XXXXXXXXXXXX----oo---------------r------------------
SXXXXXXXXXXXXXXXXXXXXXXXXXXXXXXXXXXXXXXXXX-------XXXXXXXXXXXXXXXXXXXXXXX-----------XXXXXXXXXXX----XXXXXXXXXXXX---------XXXXXXXXXXXXXXXXXXXXXXX--------
SXXXXXXXXXXXXXXXXXXXXXXXXXXXXXXXXXXXXXXXXXXXXXXXXXXXXXXXXXXXXXXXXXXXXXXXXXXXXXXXXXXXXXXXXXXXXXXXXXXXXXXXXXXXXXXXXXXXXXXXXXXXXXXXXXXXXXXXXXXXXXXXXXXXXX

