S----SSSSSSSSSSSSSSSSSSSSSSSSSSSSSSSSSSSSSSSSSSSSSSSSSSSSSSSSSSSSSSSSSSSSSSSSSSSSSSSSSSSSSSSSSSSSSSSSSSSSSSSSSSSSSSSSSSSSSSSSSSSSSSSSSSSSSSSSSSSSSSSSS
S----SSSSSSSSSSSSSSSSSSSSSSSSSSSSSSSSSSSSSS-----SSSSSS------SSSSSSSSSSSSSSSSSSSSSSSSSS-----SSSSSSSSSS------SSSSSSSSSSSSSSSSSSSS------SSSSSSSSSSSSSSSSS
S---------SSSSSSS-----SSSSSSSSSSSSSSSSSSSSS-----SSSSSS------SSSSSSSSSSSSSSSSSSSSSSSSSS-----SSSSSSSSSS------SSSSSSSSSSSSSSSSSSSS------SSSSSSSSSSSSSSSSS
S----------------------------SSSSSS-------------SSSSSS-------------SSSSS------SSSSSSSS-----SSSSSSSSSS------SSSSSS--------------------SSSSSSSSSSSSS----
S-----------------------------------------------------------------------------------------------------------------------------------------------------
S-----------------------------------------------------------------------------------------------------------------------------------------------------
S-----------------------------------------------------------------------------------------------------------------------------------------------------
S-----------------------------------------------------------------------------------------------------------------------------------------------------
S---------------------------oSoo----------------------------------------------------------------------------------------------------------------------
S----------------oooo------------------------------------------------oooS----------oSSo---------------------------------------------------------------
S------------------------ooooooooo----------------------oooSo-----------------------------------------------------------------------------------------
S-----------------oooo-----y----------------------------------------ooooo------------ooo---------------------------------------------------oSooo------
S-------------------k---XXXXXXXXXXXXXXXX----------XXXXX---oo-----------------------y------------------------------------------------------------------
S---------------XXXXXXXXXXXXXXXXXXXXXXXX----k-----XXXXX----------XXXXXXXXXXX------XXXXXXXX---oooo--r----------XXXX---XXXX------------XXX-ooooooo-XXXXX
S------------k--XXXXXXXXXXXXXXXXXXXXXXXXXXXXXXXXXXXXXXXXXXXXXX---XXXXXXXXXXX------XXXXXXXX--------XXXXXXXXXXXXXXXX---XXXXXXX---------XXX--r-k----XXXXX
SXXXXXXXXXXXXXXXXXXXXXXXXXXXXXXXXXXXXXXXXXXXXXXXXXXXXXXXXXXXXXXXXXXXXXXXXXXXXXXXXXXXXXXXXXXXXXXXXXXXXXXXXXXXXXXXXX---XXXXXXXXXXXXXXXXXXXXXXXXXXXXXXXXX

