S----SSSSSSSSSSSSSSSSSSSSSSSSSSSSSSSSSSSSSSSSSSSSSSSSSSSSSSSSSSSSSSSSSSSSSSSSSSSSSSSSSSSSSSSSSSSSSSSSSSSSSSSSSSSSSSSSSSSSSSSSSSSSSSSSSSSSSSSSSSSSSSSSS
S-----------------SSSSSSS--------------------SSSSSSSSSSSSSSSSS-----SSSSSSSS-------SSSSSS-----------SSSSSSSSSSSSSSSS------SSSSSSSS--------SSSSSSSSSSSSS
S---------------------------------------------------------------------------------SSSSSS-------------------SSSSSSSS------------------------------SSSSS
S---------------------------------------------------------------------------------SSSSSS-------------------SSSSSSSS-----------------------------------
S-----------------------------------------------------------------------------------------------------------------------------------------------------
S-----------------------------------------------------------------------------------------------------------------------------------------------------
S-----------------------------------------------------------------------------------------------------------------------------------------------------
S-----------------------------------------------------------------------------------------------------------------------------------------------------
S----------------oooS------------------------------------------------------------------oSo-----ooo------------------------oooooo---------------SooSo--
S-------------------------------------------ooS-------------------oooo---------------------------------------------ooo------------oooooSoo------------
S----------------ooo------ooooo-----------------------------------------------------------------oo----oo-------------------oooo-----------------ooooo-
S---------------------r------------------ooooooo----------ooooo-----oo------SoSoSoo----------------------k--------oo------k-------ooooooooo-----------
SXXXXXXXXXX--XXXXXXXXXXX---oo--------------r----------------------y--k---------------XXXXXX---XXXXXXXXXXXXX---------y--XXXXXXXXXX-----------XXXXXXXXXX
SXXXXXXXXXXXXXXXXXXXXXXX-----------y----XXXXXXXXXXXXXXXXXXXXXXXXXXXXXXXXXX-ooooooo---XXXXXX---XXXXXXXXXXXXX-----XXXXXXXXXXXXXXXXXXXXXXXXXXXXXXXXXXXXXX
SXXXXXXXXXXXXXXXXXXXXXXXXXXXXXXXXXXXXXXXXXXXXXXXXXXXXXXXXXXXXXXXXXXXXXXXXX-----------XXXXXXXXXXXXXXXXXXXXXX-----XXXXXXXXXXXXXXXXXXXXXXXXXXXXXXXXXXXXXX
SXXXXXXXXXXXXXXXXXXXXXXXXXXXXXXXXXXXXXXXXXXXXXXXXXXXXXXXXXXXXXXXXXXXXXXXXXXXXXXXXXXXXXXXXXXXXXXXXXXXXXXXXXXXXXXXXXXXXXXXXXXXXXXXXXXXXXXXXXXXXXXXXXXXXX

