S----SSSSSSSSSSSSSSSSSSSSSSSSSSSSSSSSSSSSSSSSSSSSSSSSSSSSSSSSSSSSSSSSSSSSSSSSSSSSSSSSSSSSSSSSSSSSSSSSSSSSSSSSSSSSSSSSSSSSSSSSSSSSSSSSSSSSSSSSSSSSSSSSS
S------------SSSSSSSSSSSSSSSSSSSSSSSSSSSSSSSSS-------SSSSSSSSSSSSSSS------SSSSSSSSSSSSSSSSSSSSSSSSSSSSSSSSSSSSSSSSSSSSSSSSS--------SSSSSSSSSSSSSSSSSS-
S------------SSSSSSSSSSSSSSSSSSS-----------------------------SSSSSSS------------SSSSSSSSSSSSSSSSSSSSS--------SSSSSSSSSSSSSS--------SSSSSSSSSSSSSSSSSS-
S-------------------SSSSSSSSSSSS-----------------------------SSSSSSS------------------SSSSSSSS---------------------SSSSSSSS--------SSSSSSSS-----------
S-----------------------------------------------------------------------------------------------------------------------------------------------------
S-----------------------------------------------------------------------------------------------------------------------------------------------------
S-----------------------------------------------------------------------------------------------------------------------------------------------------
S-----------------------------------------------------------------------------------------------------------------------------------------------------
S-----------------------------------------------------------------------------------------------------------------------------------------------------
S-------------------------------------------------------------------------------------------------------------------------oSoSSo---oSSSooo------------
S-------------------------------------oooo-----ooSoo-----------------oooooo-----ooo----oo-------------------------------------------------------------
S----------------------------SoooS----------------------------------Y--------------------------------------------------------ooo--oooooooo------------
S----------XXXXX--------------------XXXXXXXXX-----------ooo--------XXXXXXXXXX--XXXXXXXXXXXXXX------------------XX------------------y-----y------------
S----------XXXXX--------y---ooooooo-XXXXXXXXX---------------k------XXXXXXXXXXXXXXXXXXXXXXXXXX---k-y-----ooo----XXXXX--XXXXXXXXXXXXXXXXXXXXX-----------
SXXXXXXXXXXXXXXXXXXXXXXXXXX---------XXXXXXXXXXXXXXXXXXXXXXXXXXXXXXXXXXXXXXXXXXXXXXXXXXXXXXXXXXXXXXXX--------XXXXXXXX--XXXXXXXXXXXXXXXXXXXXXXXXXXX-----
SXXXXXXXXXXXXXXXXXXXXXXXXXXXXXXXXXXXXXXXXXXXXXXXXXXXXXXXXXXXXXXXXXXXXXXXXXXXXXXXXXXXXXXXXXXXXXXXXXXXXXXXXXXXXXXXXXXX--XXXXXXXXXXXXXXXXXXXXXXXXXXXXXXXX

