S----SSSSSSSSSSSSSSSSSSSSSSSSSSSSSSSSSSSSSSSSSSSSSSSSSSSSSSSSSSSSSSSSSSSSSSSSSSSSSSSSSSSSSSSSSSSSSSSSSSSSSSSSSSSSSSSSSSSSSSSSSSSSSSSSSSSSSSSSSSSSSSSSS
S----SSSSSSSSSSSSS-------SSSSSSSSSSSSSS-----SSSSSSSSSSSSSSSSSSSSSSSSSSSSSSSSSSSSSSS--------SSSSSS--------------SSSSSSS--------SSSSSSSSSSSSSSSSSSSSSSSS
S----SSSSSSSSSSSSS-------SSSSSSSSSSSSSS-----SSSSSSSSSSSSSSSSSSSSSSSSSSSSSSSSSSSSSSS--------SSSSSS--------------SSSSSSS--------SSSSSSS---------------SS
S---------SSSSSSSS---------------SSSSSS-----SSSSSSSSSSSSSS-----SSSSSSSSSSSSS---------------SSSSSS--------------SSSSSSS--------------------------------
S-----------------------------------------------------------------------------------------------------------------------------------------------------
S-----------------------------------------------------------------------------------------------------------------------------------------------------
S-----------------------------------------------------------------------------------------------------------------------------------------------------
S-----------------------------------------------------------------------------------------------------------------------------------------------------
S------------------------------oSooS----------oSS-----------------------------------------------------------------------------------------------------
S---------------------------------------------------------------------------------------------------------------------------------------ooo-----------
S--------------------SSoS-----ooooo----------oooo-----oooooo---oSo-------------oSoo------SSooSo------------oooooo-------------------------------------
S------------------------------------------------y-------------------------------------------------ooo-------------------------ooo------oo-----oSo----
S------------------oooooo--XXXXXXXXXXX-----XXXXXXXXXX----ooo---------------------ooo------ooooooo----r----XXXXXXXX----------------------------------XX
S------------XXXX----------XXXXXXXXXXXXXXXXXXXXXXXXXX---r------k-------k------------------y-------XXXXXXXXXXXXXXXX----------XXXXXXXXXXXXXXXXXX-ooo--XX
SXXXXXXXXXXXXXXXXXXXXXXXXXXXXXXXXXXXXXXXXXXXXXXXXXXXXXXXXXXXXXXXXXXXXXXXXXXXXXXXXXXXXXXXXXXXXXXXXXXXXXXXXXXXXXXXXXXXXXX-----XXXXXXXXXXXXXXXXXX---k--XX
SXXXXXXXXXXXXXXXXXXXXXXXXXXXXXXXXXXXXXXXXXXXXXXXXXXXXXXXXXXXXXXXXXXXXXXXXXXXXXXXXXXXXXXXXXXXXXXXXXXXXXXXXXXXXXXXXXXXXXXXXXXXXXXXXXXXXXXXXXXXXXXXXXXXXX

