S----SSSSSSSSSSSSSSSSSSSSSSSSSSSSSSSSSSSSSSSSSSSSSSSSSSSSSSSSSSSSSSSSSSSSSSSSSSSSSSSSSSSSSSSSSSSSSSSSSSSSSSSSSSSSSSSSSSSSSSSSSSSSSSSSSSSSSSSSSSSSSSSSS
S----SSSSSSSSSSS-----SSSSSSSSSSSSSSSSSSSSS-----SSSSSSSSSSSSSSSSSSSSSSSSSSSSSSSSSS------SSSSSSSSSSSSS------------SSSSSSSSSSSSSSSSSSSSSSSSSSSSSSSSSSSSSS
S----SSSSSSSSSSS----------------SSSSS----------SSSSSSS-----SSSSSSSSSSSSSSSSSSSSSS-------------------------------SSSSSSS------------------------------S
S----------SSSSS------------------------------------------------------SSSSSSSSSSS-------------------------------SSSSSSS------------------------------S
S-----------------------------------------------------------------------------------------------------------------------------------------------------
S-----------------------------------------------------------------------------------------------------------------------------------------------------
S-----------------------------------------------------------------------------------------------------------------------------------------------------
S-----------------------------------------------------------------------------------------------------------------------------------------------------
S-------------------------oSoo---------------------------------------------------------oSooooo--------------------------------------------------------
S-------------------------------------------ooo-------------------------------------------------------------------------------------------------------
S-------------ooSSS-------oooo--------ooo------------oSSo-----oooo------------------------oooo----oSo-----------------------------------------tt------
S----------------------------------------------------------------------------------------------------------------------oo---SoSoo-------------tt------
SXXXXXXXXXX--oooo----XXXXXXXXXXXXX--oooo-------------ooooo----ooo---XXX---------ooooo-XXXXXXXXXX---ooo------------------------------XXX-------tt------
SXXXXXXXXXX--r-------XXXXXXXXXXXXX---------XXXXXXX------------------XXXXXXXXXXX-------XXXXXXXXXX--y-------XXXXXXXXXXXXXXXX---oooo---XXX------XXXXXXXXX
SXXXXXXXXXXXXXXXXXXXXXXXXXXXXXXXXXXXXXXXXXXXXXXXXXXXXXXXXXXXXXXXXXXXXXXXXXXXXXXXXXXXXXXXXXXXXXXXXXXXXXXXXXXXXXXXXXXXXXXXXX------y-k-XXXXXXXXXXXXXXXXXX
SXXXXXXXXXXXXXXXXXXXXXXXXXXXXXXXXXXXXXXXXXXXXXXXXXXXXXXXXXXXXXXXXXXXXXXXXXXXXXXXXXXXXXXXXXXXXXXXXXXXXXXXXXXXXXXXXXXXXXXXXXXXXXXXXXXXXXXXXXXXXXXXXXXXXX

