S----SSSSSSSSSSSSSSSSSSSSSSSSSSSSSSSSSSSSSSSSSSSSSSSSSSSSSSSSSSSSSSSSSSSSSSSSSSSSSSSSSSSSSSSSSSSSSSSSSSSSSSSSSSSSSSSSSSSSSSSSSSSSSSSSSSSSSSSSSSSSSSSSS
S----SSSSSSSSSSSSS-----SSSSSSSSSS--------SSSSSSSSSSSSS-------SSSSSSSSSSSSSSSSSSSSSSSS------SSSSSSSSSSSSSSSSSSSSSSSSSS-------------------SSSSS---------
S----SSSSSSSSSSSSS-----SSSSSSSSSS--------SSSSSSSSSSSSS-------SSSSSSSSSSSSSSSSSSSSSSSS------------------------SSSSSSSS---------------------------------
S----SSSSSSS-----------SSSSSSSSSS---------------SSSSSS-------SSSSSSSSSSSS-----SSSSSSS-----------------------------------------------------------------
S-----------------------------------------------------------------------------------------------------------------------------------------------------
S-----------------------------------------------------------------------------------------------------------------------------------------------------
S-----------------------------------------------------------------------------------------------------------------------------------------------------
S-----------------------------------------------------------------------------------------------------------------------------------------------------
S----------------------------------ooSoo-------------------------ooo------------oooooo----------------------------------------------------------------
S-------------------------------------------oSSoSoo----------------------------------------------------------------------------ooooSS-----------------
S----------------oSoSoo---------oooooo-------------------------oooo--------------ooooo------------------------------------------------------------Tt--
S------------------------------------r-------ooooo-----SooSo---r--r-----ooSoo---r-----------ooo---oo----Soo-----ooS-------------------------------Tt--
SXXXXXXXXXX------ooo-----------XXXXXXXXXXX--------k----------XXXXXXXXX--------XXXXXXXXXXX----------k------------------------------------------XXXXXXXX
SXXXXXXXXXXXX---------------Y--XXXXXXXXXXXXXXXXXXXXXX-ooo----XXXXXXXXX--------XXXXXXXXXXXXXXXXXXXXXXXX---------oooooo-------y-XXXXXXXXX-------XXXXXXXX
SXXXXXXXXXXXXXXXXXXXXXXXXXXXXXXXXXXXXXXXXXXXXXXXXXXXX-y------XXXXXXXXX--------XXXXXXXXXXXXXXXXXXXXXXXX---------k---Y---XXXXXXXXXXXXXXXX-------XXXXXXXX
SXXXXXXXXXXXXXXXXXXXXXXXXXXXXXXXXXXXXXXXXXXXXXXXXXXXXXXXXXXXXXXXXXXXXXXXXXXXXXXXXXXXXXXXXXXXXXXXXXXXXXXXXXXXXXXXXXXXXXXXXXXXXXXXXXXXXXXXX---XXXXXXXXXX

