----------------------------------------------------------------------------------------------------------------------------------------------------------------------------------------------------------
----------------------------------------------------------------------------------------------------------------------------------------------------------------------------------------------------------
----------------------------------------------------------------------------------------------------------------------------------------------------------------------------------------------------------
----------------------------------------------------------------------------------------------------------------------------------------------------------------------------------------------------------
-------------------------------------------------------------------------------------------------------------------------------------------------------------------------##-------------------------------
---------------------------------------------------------------------------------------g--------------------------------------------------------------------------------###-------------------------------
---------------------------------------------------------------##---------------------SSSSSSS--------------------------------------------------------------------------####-------------------------------
--------------------------------------------------------------###-----------------------------------------------------------------------------------------------------#####----------------------#--------
-----------------S!!S----------------------------------------####------------------------------------@-----------------------------------------------SSS!------------######---------------------##--------
------------------------------------------------------------#####--------------------------------------------------1-------------------------------------------1----#######--------------------###--------
-----------------------------!-----------#-----------------######-------------tt-----!----------------SS!S-------------------------C-tt----------------------------tt---------SU------------------SU------
----------------------------------------##----------------#######-tt----------tt-----------------------------------------------------tt----------------------------tt-------------------------------------
----------#######----tt-#--------------###------------tt-########-tt----------tt--------------#######-------------------tt-----------tt-------tt-########----------tt--------------tt-#-------------------
-M--------#######----tt##----k---g----####-----gg-g---tt#########-tt-g----g-g-tt--------------#######-------gg----------tt-----------tt-------tt#########----------tt----g-g-------tt##------g-g----------
XXXXXXXXXXXXXXXXXXXXXXXXXXXXXXXXXXXXXXXXXXXXXXXXXXXXXXXXXXXXXXXXXXXXXXXXXXXXXXXXXXXXXXXXXXXX--XXXXXXXXXXXXXXXXXXXXXXXXXXXXXXX-XXXXXXXXXXXXXXXXXXXXXXXXXXXXXXXXXXXXXXXXXXXXXXXXXXXXXXXXXXXXXXXXXXXXXX-XXXXX
XXXXXXXXXXXXXXXXXXXXXXXXXXXXXXXXXXXXXXXXXXXXXXXXXXXXXXXXXXXXXXXXXXXXXXXXXXXXXXXXXXXXXXXXXXXX--XXXXXXXXXXXXXXXXXXXXXXXXXXXXXXX-XXXXXXXXXXXXXXXXXXXXXXXXXXXXXXXXXXXXXXXXXXXXXXXXXXXXXXXXXXXXXXXXXXXXXX-XXXXX
