----------------------------------------------------------------------------------------------------------------------------------------------------------------------------------------------------------
----------------------------------------------------------------------------------------------------------------------------------------------------------------------------------------------------------
----------------------------------------------------------------------------------------------------------------------------------------------------------------------------------------------------------
----------------------------------------------------------------------------------------------------------------------------------------------------------------------------------------------------------
----------------------------------------------------------------------------------------------------------------------------------------------------------------------------------------------------------
---------------------g------------------------------------------------------------------------------------------------------------------------------------------------------------------------------------
--------------------SSSSSSS-------------------------------------------------------------------------------------------------------------------------------------------------------------------------------
----------------------------------------------------------------------------------------------------------------------------------------------------------------------------------------------------------
--------------------------------------------------------------------------------------------------------------------SSS!----------------------------------------------------------------------------------
----------------------------------------------------------------------------------------------------------------------------------------------------------------------------------------------------------
------------------------------SUSS!S---------tt-----------------------S--#----------##--#------------------C-----t--------------!-------------tt-----SU----------------#--#-------#------tt---------------
---tt----------------------------------------tt--------------------------##--------###--##-----------------------t----------------------------tt----------------------##--##------##-----tt---------------
---tt----------------------------------------tt--tt------tt-#------------###------####--###------tt-#------------tt#######--------------------tt---------------------###--###-----###----tt------tt-------
-M-tt-g------------------g-g----------gg-g-g-tt--tt------tt##-g----####--####----#####--####-----tt##--------g-g-tt#######----------------g-g-ttg-g------------g----####--####----####---tt------tt---g-g-
XXXXXXXXXXXX--XXXXXXXXX--XXXXXXXXXXXXXXXXXXXXXXXXXXXXXXXXXXXXXXXXXXXXXXXXXXXXXXXXXXXXX--XXXXXXXXXXXXX-XXXXXXXXXXXXXXXXXXXXXXXXXXXXXXXXX--XXXXXXXXXXXXXXXXXXXXXXXXXXXXXXXXXXXXXXXX-XXXXXXXXXXXXXXXXXXXXXXXX
XXXXXXXXXXXX--XXXXXXXXX--XXXXXXXXXXXXXXXXXXXXXXXXXXXXXXXXXXXXXXXXXXXXXXXXXXXXXXXXXXXXX--XXXXXXXXXXXXX-XXXXXXXXXXXXXXXXXXXXXXXXXXXXXXXXX--XXXXXXXXXXXXXXXXXXXXXXXXXXXXXXXXXXXXXXXX-XXXXXXXXXXXXXXXXXXXXXXXX
