----------------------------------------------------------------------------------------------------------------------------------------------------------------------------------------------------------
----------------------------------------------------------------------------------------------------------------------------------------------------------------------------------------------------------
----------------------------------------------------------------------------------------------------------------------------------------------------------------------------------------------------------
----------------------------------------------------------------------------------------------------------------------------------------------------------------------------------------------------------
----------------------------------------------------------------------------------------------------------------------------------------------------------------------------------------------------------
-------------------------------------------------------------------------g--------------------------------------------------------------------------------------------------------------------------------
---------------------------##-------------------------------------------SSSSSSS------------------------------------------------------S----------------------------------S---------------------------------
--------------------------###-----------------------------------------------------------------------------------------------------------------------------------------------------------------------------
-------------------------####-------------------------------------------------------------------------------------------------------g----------------------------------g----------------------------------
------------------------#####-----------------------------------------------------------------------------------------------------------------------------------------------------------------------------
------------S----------######-SS!S----------SS!S--------------------S---------------C-----tt------------tt-------SS!S---------!---S@S-S-------tt---------tt----------S@S-------------SU-------------SS!S--
----------------------#######-------------------------------------------------------------tt------------tttt----------------------------------tt---------tt-----------------------------------------------
----------------------#######-------------------------------------------------------------tt---tt-#-----tttt-----------------------------XTT--tt---------tt------------------------------------tt---------
-M--g----####-----gg-g#######-------gg------------gg----------------------gg-g--------g-g-tt---tt##-g-g-tttt-g---------gg-----------------tt--tt-----g-g-tt---------------------g-g------------tt---------
XXXXXXXXXXXXXXXXXXXXXXXXXXXXXXXXXXXXXXXXXXXXXXXXXXXXXXXXXXXXXXXXXXXXXXXXXXXXXX-XXXXXXXXXXXXXXXXXXXXXXXXXXXXXXXXXXXXXXXXXXXXXXXXXXXXXXXXXXXXXXXXXXXXXXXXXXXXXX--XXXXXXXXXXXXXXX--XXXXXXXXXXXXXXXXXXXXXXXXXX
XXXXXXXXXXXXXXXXXXXXXXXXXXXXXXXXXXXXXXXXXXXXXXXXXXXXXXXXXXXXXXXXXXXXXXXXXXXXXX-XXXXXXXXXXXXXXXXXXXXXXXXXXXXXXXXXXXXXXXXXXXXXXXXX------XXXXXXXXXXXXXXXXXXXXXXX--XXXX------XXXXX--XXXXXXXXXXXXXXXXXXXXXXXXXX
