----------------------------------------------------------------------------------------------------------------------------------------------------------------------------------------------------------
----------------------------------------------------------------------------------------------------------------------------------------------------------------------------------------------------------
----------------------------------------------------------------------------------------------------------------------------------------------------------------------------------------------------------
----------------------------------------------------------------------------------------------------------------------------------------------------------------------------------------------------------
---------------------------------------------------------------------------------------------------------------------------------------------##-----------------------------------------------------------
--------------------------------------------------------------------------------------------------------------------------------------------###-----------------------------------------------------------
---------------------------------------------SSS!-----------------------------S------------------------------------------------------------####-----------------------------------------------------------
------------------------------------------------------------------------------------------------------------------------------------------#####-----------------------------------------------------------
------SSS!-------------------------------------------------------------------g-----------------------------------------------------------######-----------------------------------------------------------
-----------------------------------------------------------------------------------------------------------------------------------1----#######-----------------------------------------------------1-----
-----------------------------------------#---------SS!S----------------!---S@S---------------tt---------------------!-----------------------------SU-------------------tt----!--SS!S----------------------
----------------------------------------##-----------------tt--------------------------------tt----tt------------------------------------------------------------------tt---------------------------------
---#######---tt------------------------###-----------------tt--------------------------------tt----tt------------------------------------tt-#---------tt---------------tt-----------------tt--------------
-M-#######---tt------------------g----####-----gg-g------ggtt-g------------------------------tt----tt-g-------------k--------------------tt##g-g------tt-----------g-g-tt----k--------gg--tt--------------
XXXXXXXXXXXXXXXXXXXXXXXXXXXXXXXXXXXXXXXXXXXXXXXXXXXXXXXXXXXXXXXXXXXXXXXXXXXXXXXXXXXX--XXXXXXXXXXXXXXXXXXXXXXXXXXXXXXXXXXXXXXXXXXXXXXXXXXXXXXXXXXXXXXXXXXXXXXXXXXXXXXXXXXXXXXXXXXXXXXXXXXXXXXXXXXXXXXXXXXXX
XXXXXXXXXXXXXXXXXXXXXXXXXXXXXXXXXXXXXXXXXXXXXXXXXXXXXXXXXXXXXXXXXXXXXXXXX------XXXXX--XXXXXXXXXXXXXXXXXXXXXXXXXXXXXXXXXXXXXXXXXXXXXXXXXXXXXXXXXXXXXXXXXXXXXXXXXXXXXXXXXXXXXXXXXXXXXXXXXXXXXXXXXXXXXXXXXXXX
