----------------------------------------------------------------------------------------------------------------------------------------------------------------------------------------------------------
----------------------------------------------------------------------------------------------------------------------------------------------------------------------------------------------------------
----------------------------------------------------------------------------------------------------------------------------------------------------------------------------------------------------------
----------------------------------------------------------------------------------------------------------------------------------------------------------------------------------------------------------
----------------------------------------------------------------------------------------------------------------------------------------------------------------------------------------------------------
--------------------------------------------------------------------------------------------------------------g-----------------------------------------------------------g-------------------------------
-------------------------------------------------------------------S-----------------------------------------SSSSSSS-------------------!-----------------S!!S------------SSSSSSS--------------------S-----
----------------------------------------------------------------------------------------------------------------------------------------------------------------------------------------------------------
------------------------------------------------------------------g--------------------------------------------------------------------------------------------------------------------------------g------
---------------1----------------------------------------------------------------1-------------------------------------------------------------------------------------------------------------------------
-------------------tt-----------SS!S------------------------!---S@S-S-------------------------tt-----------!--------C-tt---------!---S@S!S----------!-------SU---------#-------------!-------!---S@S------
---tt--------------tt----tt-------------------------------------------------------------------tt----------------------tt----------------------------------------------##----------------------------------
---tt--------------tt----tt--------------------------------------------XTT--------------------tt--tt------------------tt--------------------XTT----------------------###----------------------------------
-M-tt-g------------tt----tt-g---------gg--------------------------------tt----------------g-g-tt--tt-------k----------tt--------------g------tt-----k--g-g-----g----####-----gg-g----k--------------------
XXXXXXXXXXXXXXXXXXXXXXXXXXXXXXXXXXXXXXXXXX--XXXXXXXXX--XXXXXXXXXXXXXXXXXXXXXXXXXXXXXXXXXXXXXXXXXXXXXXXXXXXXXXX-XXXXXXXXXXXXXXXXXXXXXXXXXXXXXXXXXXXXXXXXXXXXXXXXXXXXXXXXXXXXXXXXXXXXXXXXXXXXXXXXXXXXXXXXXXX
XXXXXXXXXXXXXXXXXXXXXXXXXXXXXXXXXXXXXXXXXX--XXXXXXXXX--XXXXXXX------XXXXXXXXXXXXXXXXXXXXXXXXXXXXXXXXXXXXXXXXXX-XXXXXXXXXXXXXXXXXXXX------XXXXXXXXXXXXXXXXXXXXXXXXXXXXXXXXXXXXXXXXXXXXXXXXXXXXXX------XXXXX
