----------------------------------------------------------------------------------------------------------------------------------------------------------------------------------------------------------
----------------------------------------------------------------------------------------------------------------------------------------------------------------------------------------------------------
----------------------------------------------------------------------------------------------------------------------------------------------------------------------------------------------------------
----------------------------------------------------------------------------------------------------------------------------------------------------------------------------------------------------------
----------------------------------------------------------------------------------------------------------------------------------------------------------------------------------------------------------
-------------------------------------------------------------------------------------------------------------------------g---------------------------------------------------------------------g----------
-------------------------------------------------------------------------------------------S----------------------------SSSSSSS---------------------------------------------------------------SSSSSSS-----
----------------------------------------------------------------------------------------------------------------------------------------------------------------------------------------------------------
------------------------------------------------------------------------------------------g---------------------------------------------------------------------------------------------------------------
----------------------------------------------------------------------------------------------------------------------------------------------------------------------------------------------------------
-----------------------------------------tt----!-----------------------------tt-----!---S@S-S-----------ttSS!S---------tt----!-----------S--------------tt--------tt-------------#----------------------SU
-----------------------tt----------------tt----------------------------------tt-------------------------tt-------------tt-------------------------------tttt------tt------------##------------------------
------------------tt---tt----------------tt------------------------tt--------tt----------------XTT------tt-------------tt-------------------------------tttt------tt-----------###---------#######--------
-M----------------tt---tt-g----------g-g-tt----k-------------------tt----g-g-tt-----------------tt--g-g-tt------gg-g-g-tt----k---g----####-----gg-g-g-g-tttt-g----tt-----g----####-----gg-g#######-g-g----
XXXXXXXXXXXXXXXXXXXXXXXXXXXXXXXXXXXXXXXXXXXXXXXXXXXX--XXXXXXXXX--XXXXXXXXXXXXXXXXXXXXXXXXXXXXXXXXXXXXXXXXXXXXXXXXXXXXXXXXXXXXXXXXXXXXXXXXXXXXXXXXXXXXXXXXXXXXXXXXXXXXXXXXXXXXXXXXXXXXXXXXXXXXXXXXXXXXXXXXX
XXXXXXXXXXXXXXXXXXXXXXXXXXXXXXXXXXXXXXXXXXXXXXXXXXXX--XXXXXXXXX--XXXXXXXXXXXXXXXXXXXXX------XXXXXXXXXXXXXXXXXXXXXXXXXXXXXXXXXXXXXXXXXXXXXXXXXXXXXXXXXXXXXXXXXXXXXXXXXXXXXXXXXXXXXXXXXXXXXXXXXXXXXXXXXXXXXX
