----------------------------------------------------------------------------------------------------------------------------------------------------------------------------------------------------------
----------------------------------------------------------------------------------------------------------------------------------------------------------------------------------------------------------
----------------------------------------------------------------------------------------------------------------------------------------------------------------------------------------------------------
----------------------------------------------------------------------------------------------------------------------------------------------------------------------------------------------------------
-------------------------------------------------------------------------------------------------------------------------------------------------------------------------------------------g--------------
-------------------------------------------------------!-----------------S!!S-----------------------------------SSS!--------------------------------------------------------------!-------SSSSSSS---------
----------------------------------------------------------------------------------------------------------------------------------------------------------------------------------------------------------
----------------------------------------------------------------------------------------------------------------------------------------------------------------------------------------------------------
-------------------------------------------------------------------------------------------------------------------------------S--------------------------------------------------------------------------
-------------------------------------------------!---S@S!S------------------SU-------------------C-----------------!--------------------------#--#----------##--#---------------S@S!S----------!----------
--------!-S------SS!S------------SS!S--------------------------------------------------------------------------------------------------------##--##--------###--##----------------------------------------
--------------------------------#---------------------------XTT-------------------------------------------------------#######---tt----------###--###------####--###--------------------XTT----------------
-------------XTT---------#######---------g-g----------g------tt--------g-g-----------------------------------------k--#######---tt----g----####--####----#####--####-------------g------tt-----k----------
-M------------tt-------gg#######-------ggXXXXXXXXXXXXXXXXXXXXXXXXXXXXXXXXXXXXXXXXXXXXXXXXXX-XXXXXXXXXXXXXXXXXXXXXXXXXXXXXXXXXXXXXXXXXXXXXXXXXXXXXXXXXXXXXXXXXX--XXXXXXXX--XXXXXXXXXXXXXXXXXXXXXXXXXXXXXXXX
XXXXXXXXXXXXXXXXXXXXXXXXXXXXXXXXXXXXXXXXXXXXXXXXXXX------XXXXXXXXXXXXXXXXXXXXXXXXXXXXXXXXXX-XXXXXXXXXXXXXXXXXXXXXXXXXXXXXXXXXXXXXXXXXXXXXXXXXXXXXXXXXXXXXXXXXX--XXXXXXXX--XXXX------XXXXXXXXXXXXXXXXXXXXXX
XXXXXXXXXXXXXXXXXXXXXXXXXXXXXXXXXXXXXXXXX-----------------------------------------------------------------------------------------------------------------------------------------------------------------
