----------------------------------------------------------------------------------------------------------------------------------------------------------------------------------------------------------
----------------------------------------------------------------------------------------------------------------------------------------------------------------------------------------------------------
----------------------------------------------------------------------------------------------------------------------------------------------------------------------------------------------------------
----------------------------------------------------------------------------------------------------------------------------------------------------------------------------------------------------------
----------------------------------------------------------------------------------------------------------------------------------------------------------------------------------------------------------
----------------------------------------------------------------------------------------------------------------------------------------------------------------------------------------------------------
------------------------------------------------------------------------------------------------------S---------------------------------------------------------------------------------------------------
----------------------------------------------------------------------------------------------------------------------------------------------------------------g-----------------------------------------
-----------------------------------------------------------------------------------------------------g---------------------------------------------------------SSSSSSS------------------------------------
-------------------------------------------------------------------------------------------------------------------1---------------------------------1-----------------------------1----------------------
-------!---------------C----------------#--#-------#--------------S--#----------##--#----------!---S@S-------------------------S--#-------#--------------tt-----------------tt-------------!-S------------
---------------------------------------##--##------##----------------##--------###--##--------------------------------------------##------##-------------tt-----------------tt----------------------------
------------tt-------------tt-#-------###--###-----###---------------###------####--###-------------------------------------------###-----###------------tt----#######------tt------------------XTT-------
-M-----k----tt-------------tt##-g----####--####----####--------------####----#####--####------------------------------------------####----####-----------tt----#######--g-g-tt-------------------tt-------
XXXXXXXXXXXXXXXXX-XXXXXXXXXXXXXXXXXXXXXXXXXXXXXXXX-XXXXXXXXXXXXXXXXXXXXXXXXXXXXXXX--XXXXXXXXXXXXXXXXXXXXXXXX--XXXXXXXXXXXXXXXXXXXXXXXXXXX-XXXXXXXXXXXXXXXXXXXXXXXXXXXXXXXXXXXXXXXXXXXXXXXXXXXXXXXXXXXXXXXX
XXXXXXXXXXXXXXXXX-XXXXXXXXXXXXXXXXXXXXXXXXXXXXXXXX-XXXXXXXXXXXXXXXXXXXXXXXXXXXXXXX--XXXXXXXXXXXXX------XXXXX--XXXXXXXXXXXXXXXXXXXXXXXXXXX-XXXXXXXXXXXXXXXXXXXXXXXXXXXXXXXXXXXXXXXXXXXXXXXXXXXXXXXXXXXXXXXX
