----------------------------------------------------------------------------------------------------------------------------------------------------------------------------------------------------------
----------------------------------------------------------------------------------------------------------------------------------------------------------------------------------------------------------
----------------------------------------------------------------------------------------------------------------------------------------------------------------------------------------------------------
----------------------------------------------------------------------------------------------------------------------------------------------------------------------------------------------------------
-----------------------------------------##---------------------------------------------------------------------------------------------------------------------------------------------------------------
----------------------------------------###-----------------------------------------------------------------------------------g--------------------------------------------------------------g------------
---------------------------------------####----------------------------------------------------------------------------------SSSSSSS--------------------------------------------------------SSSSSSS-------
--------------------------------------#####---------------------------------------------------------------------------------------------------------------------------------------------------------------
-------------------------------------######------SSS!-----------------------------------------------------------------------------------------------------------------------------------------------------
------------------------------------#######-----------------------------------------------------------------------------------------------------------------------------------1---------------------------
------------S------------------#--------------S---------SS!S----------------------------------#--#----------##--#------------------------!---tt----SS!S---------!-S-----------------------#---------SS!S--
------------------------------##----------------------------------------------tt-------------##--##--------###--##---------------------------tt------------------------------------------##---------------
-----------------------------###----------------#######------------------tt---tt------------###--###------####--###--------------------------tt----------------------XTT----------------###---------------
-M----------------gg-g---------------gg-gg-g----#######-------gg---------tt---tt-g----g----####--####----#####--####---------------------k---tt----------gg-----------tt------------------------gg-g------
XXXXXXXXXXXXXXXXXXXXXXXXXXXXXXXXXXXXXXXXXXXXXXXXXXXXXXXXXXXXXXXXXXXXXXXXXXXXXXXXXXXXXXXXXXXXXXXXXXXXXXXXXXXXXX--XXXXXXXX--XXXXXXXXX--XXXXXXXXXXXXXXXXXXXXXXXXXXXXXXXXXXXXXXXXXXXXXXXXXXXXXXXXXXXXXXXXXXXXX
XXXXXXXXXXXXXXXXXXXXXXXXXXXXXXXXXXXXXXXXXXXXXXXXXXXXXXXXXXXXXXXXXXXXXXXXXXXXXXXXXXXXXXXXXXXXXXXXXXXXXXXXXXXXXX--XXXXXXXX--XXXXXXXXX--XXXXXXXXXXXXXXXXXXXXXXXXXXXXXXXXXXXXXXXXXXXXXXXXXXXXXXXXXXXXXXXXXXXXX
