----------------------------------------------------------------------------------------------------------------------------------------------------------------------------------------------------------
----------------------------------------------------------------------------------------------------------------------------------------------------------------------------------------------------------
----------------------------------------------------------------------------------------------------------------------------------------------------------------------------------------------------------
----------------------------------------------------------------------------------------------------------------------------------------------------------------------------------------------------------
----------------------------------------------------------------------------------------------------------------------------------------------------------------------------------------------------------
--------------------------------------g-------------------------------------------------------------------------------------------------------------------------------------------------------------------
-------------------------------------SSSSSSS--------------------------------------------------------------------------------------------------------------------------------------------------------------
----------------------------------------------------------------------------------------------------------------------------------------------------------------------------------------------------------
-----------------------------------------------------------------------------------------------------------------@----------------------------------------------------------------------------------------
----------------------------1-----------------------------------------------------------------------------------------------------------------------------------------------------------------------------
---------C----------------------------------C-----------------------#--#----------##--#---------------------------------------tt--------------S------SS!S---------SU---------S--#-------#-----------------
---------------------------------------------tt--------------------##--##--------###--##--------------------------------------tt------------------------------------------------##------##----------------
---------------------------------------------tt--------tt-#-------###--###------####--###-------------tt-########-------------tt-----------------XTT----------------------------###-----###---------------
-M-------------------------------------------tt-g------tt##-g----####--####----#####--####------------tt#########---------g-g-tt------------------tt-------ggg-g-----g----####--####----####--------------
XXX-XXXXXXXXXXXXXXXXXXXXXXXXXXXXXXXXXX-XXXXXXXXXXXXXXXXXXXXXXXXXXXXXXXXXXXXXXXXXXXXX--XXXXXXXXXXXXXXXXXXXXXXXXXXXXXXXXXXXXXXXXXXXXXXXXXX--XXXXXXXXXXXXXXXXXXXXXXXXXXXXXXXXXXXXXXXXXXXXX-XXXXXXXXXXXXXXXXXX
XXX-XXXXXXXXXXXXXXXXXXXXXXXXXXXXXXXXXX-XXXXXXXXXXXXXXXXXXXXXXXXXXXXXXXXXXXXXXXXXXXXX--XXXXXXXXXXXXXXXXXXXXXXXXXXXXXXXXXXXXXXXXXXXXXXXXXX--XXXXXXXXXXXXXXXXXXXXXXXXXXXXXXXXXXXXXXXXXXXXX-XXXXXXXXXXXXXXXXXX
