----------------------------------------------------------------------------------------------------------------------------------------------------------------------------------------------------------
----------------------------------------------------------------------------------------------------------------------------------------------------------------------------------------------------------
----------------------------------------------------------------------------------------------------------------------------------------------------------------------------------------------------------
----------------------------------------------------------------------------------------------------------------------------------------------------------------------------------------------------------
----------------------------------------------------------------------------------------------------------------------------------------------------------------------------------------------------------
---------------------------------------------------------------------------------------------------------------------------------------------------------g------------------------------------------------
---------------------------------------------------------S----!--------------------------------------------------------!------S-------------------------SSSSSSS-------------------------------------------
----------------------------------------------------------------------------------------------------------------------------------------------------------------------------------------------------------
--------------------------------------------------------g-------------------------------------------------@------------------g----------------------------------------------------------------------------
---------------------------------------#------------------------------------------------------------------------------------------------------------------------------------------------------------------
----tt--------------------------------##----------!---S@S---S@S!----------------------tt---------tt------------------S@S!--S@S-------------tt---------#-----------------------------CSS!S-------------S--#
----tt-------------------------------###-------------------------------tt-------------tt---------tt----------------------------------------tt--------##--------------------------------------------------#
----tt------tt-----------tt---#######----------------------------------tt-------tt----tt---------tt#######---------------------------------tt-------###-----------tt-------------------------------------#
-M--tt------tt-----------tt---#######------------------------g---------tt-g-----tt----tt-----g-g-tt#######------------g----------------g-g-tt-g----####-----gg-g--tt-----------------------gg-g----####--#
XXXXXXXXXXXXXXXXXXXXXXXXXXXXXXXXXXXXXXXXXXXXXXXXXXXXXXXXXXXXXXXXXXXXX--XXXXXXXXXXXXXXXXXXXXXXXXXXXXXXXXXXXXXX--XXXXXXXXXXXXXXXXXXXXX--XXXXXXXXXXXXXXXXXXXXXXXXXXXXXXXXXXXXXXXX-XXXXXXXXXXXXXXXXXXXXXXXXXXX
XXXXXXXXXXXXXXXXXXXXXXXXXXXXXXXXXXXXXXXXXXXXXXXXXXXX------------XXXXX--XXXXXXXXXXXXXXXXXXXXXXXXXXXXXXXXXXXXXX--XXXX------------XXXXX--XXXXXXXXXXXXXXXXXXXXXXXXXXXXXXXXXXXXXXXX-XXXXXXXXXXXXXXXXXXXXXXXXXXX
