----------------------------------------------------------------------------------------------------------------------------------------------------------------------------------------------------------
----------------------------------------------------------------------------------------------------------------------------------------------------------------------------------------------------------
----------------------------------------------------------------------------------------------------------------------------------------------------------------------------------------------------------
----------------------------------------------------------------------------------------------------------------------------------------------------------------------------------------------------------
----------------------------------------------------------------------------------------------------------------------------------------------------------------------------------------------------------
----------------------------------------------------------------------------------------------------------------------------------------------------------------------------------------------------------
--------------------------------------------------------------------------------------------------------------------------------------------------------------------------S----!------S-----SSS!----------
--------------------------------------------------------------------------------------------------------------------#-------------------------------------------------------------------------------------
-------------------------------------------------------------------------------------------------------------------##-----SSS!------------------------------S!!S---------g-----------g--------------------
------------------------------------------------------------------------------------------------------------------###-------------------------------------------------------------------------------------
---------CSS!S-----------SS!S-------------------#--------------tt----------------S--#----------##--#-----------------SU----------------------SS!S----------------------S@S---S@S!--S@S-------------SU-----
-----------------------------------------------##--------------tt-------------------##--------###--##-----------------------------------------------------------------------------------------------------
----------------------------------------------###--------------tt-------------------###------####--###------tt-#-------#######----------tt-----------#######-------------------------------------------tt-
-M--------------gg-------------gg---------------------gg-g-g-g-tt--------g----####--####----#####--####-----tt##g-g----#######----------tt---------gg#######------------------g---------------g-g------tt-
XXX-XXXXXXXXXXXXXXXXXXXXXXXXXXXXXXXXXXXXXXXXXXXXXXXXXXXXXXXXXXXXXXXXXXXXXXXXXXXXXXXXXXXXXXXXXXXXX--XXXXXXXXXXXXXXXXXXXXXXXXXXXXXXXXXXXXXXXXXXXXXXXXXXXXXXXXXXXX--XXXXXXXXXXXXXXXXXXXXXXXXXXX--XXXXXXXXXXXX
XXX-XXXXXXXXXXXXXXXXXXXXXXXXXXXXXXXXXXXXXXXXXXXXXXXXXXXXXXXXXXXXXXXXXXXXXXXXXXXXXXXXXXXXXXXXXXXXX--XXXXXXXXXXXXXXXXXXXXXXXXXXXXXXXXXXXXXXXXXXXXXXXXXXXXXXXXXXXX--XXXX------------------XXXXX--XXXXXXXXXXXX
