----------------------------------------------------------------------------------------------------------------------------------------------------------------------------------------------------------
----------------------------------------------------------------------------------------------------------------------------------------------------------------------------------------------------------
----------------------------------------------------------------------------------------------------------------------------------------------------------------------------------------------------------
----------------------------------------------------------------------------------------------------------------------------------------------------------------------------------------------------------
----------------------------------------------------------------------------------------------------------------------------------------------------------------------------------------------------------
----------------------------------------------------------------------------------------------------------------------------------------------------------------------------------------------------------
----------------------------------------------------------------------------------------------------------------------------------------------------------------------------------------------------------
-------------------------------------------------------------------------------------#--------------------------------------------------------------------------------------------------------------------
-------------------------------------------------------------------SSS!-------------##--------------------------------------------------------------------------------------------------------------------
-----------------------------------------------------------------------------------###-------1------------------------------------------------------------------------------------------------------------
---SS!S-----------SS!S-------------S--#-------#-------------tt------------------------SU----------------------SS!S-------------S--#----------##--#---------!----------tt-------------#--------------------
--------------------------------------##------##------------tt--------------------------------------------------------------------##--------###--##-------------------tt------------##--------------------
--------------------------------------###-----###-----------tt----#######---tt---------------------tt-#---------------------------###------####--###------------tt----tt-----------###---------#######----
-M-------gg-------------gg------------####----####----------tt----#######---tt---g-g---------------tt##-------------gg-g----####--####----#####--####------k----tt----tt-------------------gg-g#######----
XXXXXXXXXXXXXXXXXXXXXXXXXXXXXXXXXXXXXXXXXXXXX-XXXXXXXXXXXXXXXXXXXXXXXXXXXXXXXXXXXXXXXXXXXXXXXXXXXXXXXXXXXXXXXXXXXXXXXXXXXXXXXXXXXXXXXXXXXXXXXXX--XXXXXXXXXXXXXXXXXXXXXXXXXXXXXXXXXXXXXXXXXXXXXXXXXXXXXXXXX
XXXXXXXXXXXXXXXXXXXXXXXXXXXXXXXXXXXXXXXXXXXXX-XXXXXXXXXXXXXXXXXXXXXXXXXXXXXXXXXXXXXXXXXXXXXXXXXXXXXXXXXXXXXXXXXXXXXXXXXXXXXXXXXXXXXXXXXXXXXXXXX--XXXXXXXXXXXXXXXXXXXXXXXXXXXXXXXXXXXXXXXXXXXXXXXXXXXXXXXXX
