----------------------------------------------------------------------------------------------------------------------------------------------------------------------------------------------------------
----------------------------------------------------------------------------------------------------------------------------------------------------------------------------------------------------------
----------------------------------------------------------------------------------------------------------------------------------------------------------------------------------------------------------
----------------------------------------------------------------------------------------------------------------------------------------------------------------------------------------------------------
----------##----------------------------------------------------------------------------------------------------------------------------------------------------------------------------------------------
---------###---------------------------------------------------------------------------------------------------------------------------g------------------------------------------------------------------
--------####--------------------------------------------------------------------------------------------------------------------------SSSSSSS-------------------------!-----------------------------------
-------#####----------------------------------------------------------------------------------------------------------------------------------------------------------------------------------------------
------######----------------------------------------------------------------------------------------------------------------------------------------------------------------------------------------------
-----#######----------1-----------------------------------------------------------------------------------------------------------------------------------------------------------------------------------
--------tt-----SU------------------------#--#-------#----------------------------#--#----------##--#--------------------tt---------!--------------C-----------------S@S!S---------------S--#-------#------
--------tt------------------------------##--##------##--------------------------##--##--------###--##-------------------tt-----------------------------------------------------------------##------##-----
--------tt-----------------------------###--###-----###------tt-#--------------###--###------####--###------tt-#--------tt---------------------------tt--------------------XTT-------------###-----###----
-M--g-g-ttg-g-------------------------------####----####-----tt##--------g----####--####----#####--####-----tt##--------tt---------------------------tt--------------g------tt-------------####----####---
XXXXXXXXXXXXXXXXXXXXXXXXXXXXXXXXXXXXXXXXXXXXXXXXXXX-XXXXXXXXXXXXXXXXXXXXXXXXXXXXXXXXXXXXXXXXXXXXX--XXXXXXXXXXXXXXXXXXXXXXXXXXXXXXXXXXXXXXX---XXXXXXXXXXXXXXX--XXXXXXXXXXXXXXXXXXXXXXXXXXXXXXXXXXXX-XXXXXXX
XXXXXXXXXXXXXXXXXXXXXXXXXXXXXXXXXXXXXXXXXXXXXXXXXXX-XXXXXXXXXXXXXXXXXXXXXXXXXXXXXXXXXXXXXXXXXXXXX--XXXXXXXXXXXXXXXXXXXXXXXXXXXXXXXXXXXXXXX---XXXXXXXXXXXXXXX--XXXX------XXXXXXXXXXXXXXXXXXXXXXXXXX-XXXXXXX
