----------------------------------------------------------------------------------------------------------------------------------------------------------------------------------------------------------
----------------------------------------------------------------------------------------------------------------------------------------------------------------------------------------------------------
----------------------------------------------------------------------------------------------------------------------------------------------------------------------------------------------------------
----------------------------------------------------------------------------------------------------------------------------------------------------------------------------------------------------------
----------------------------------------------------------------------------------------------------------------------------------------------------------------------------------------------------------
------------------------------------------------------------------------------------------------------------g---------------------------------------------------------------------------------------------
-----------------------S----!------------------------------------------------------------------------------SSSSSSS--------------SSS!---------------------------------------------------------------SSS!---
----------------------------------------------------------------------------------------------------------------------------------------------------------------------------------------------------------
----------------------g-----------------------------------------------------------------------------------------------------------------------------------------------------------------------------------
--------------------------------------------------1-------------------------------------------------------------------------------------------------------------------------------------------------------
--------------------S@S---S@S!-------SS!S------------SS!S--------------------------tt---------tt---------#------------------S--------------------------------#--#-------#---------------!-------------!--S
-------------------------------------------------------------tt--------------------tt---------tt--------##-----------------------------------tt-------------##--##------##--------------------------------
-------------------------------------------------------------tt--------tt-#--tt----tt---------tt-------###------------------------------tt---tt------------###--###-----###-------------------tt-#--------
-M-------------------------g---------------gg--------------ggtt-g------tt##--tt----tt-----g-g-tt-g----####-----gg-g---------------gg-g--tt---tt-g----g----####--####----####------------k-----tt##----k---
XXXXXXXXXXXX--XXXXXXXXXXXXXXXXXXXXX--XXXXXXXXXXXXXXXXXXXXXXXXXXXXXXXXXXXXXXXXXXXXXXXXXXXXXXXXXXXXXXXXXXXXXXXXXXXXXXXXXXXXXXXXXXXXXXXXXXXXXXXXXXXXXXXXXXXXXXXXXXXXXXXXXX-XXXXXXXXXXXXXXXXXXXXXXXXXXXXXXXXXX
XXXXXXXXXXXX--XXXX------------XXXXX--XXXXXXXXXXXXXXXXXXXXXXXXXXXXXXXXXXXXXXXXXXXXXXXXXXXXXXXXXXXXXXXXXXXXXXXXXXXXXXXXXXXXXXXXXXXXXXXXXXXXXXXXXXXXXXXXXXXXXXXXXXXXXXXXXX-XXXXXXXXXXXXXXXXXXXXXXXXXXXXXXXXXX
