----------------------------------------------------------------------------------------------------------------------------------------------------------------------------------------------------------
----------------------------------------------------------------------------------------------------------------------------------------------------------------------------------------------------------
----------------------------------------------------------------------------------------------------------------------------------------------------------------------------------------------------------
----------------------------------------------------------------------------------------------------------------------------------------------------------------------------------------------------------
----------------------------------------------------------------------------------------------------------------------------------------------------------------------------------------------------------
----------------------------------------------------------------------------------------------------------------------------------------------------------------------------------------------------------
--------------------------------------------------------------------------SSS!---------------------------------------------------------##-----------------------------------------------------------------
--------------------------------------------------------------------------------------------------------------------------------------###-----------------------------------------------------------------
-------------------------------------------------------------------------------------------------------------------------------------####-----------------------------------------------------------------
-------------------------------------------------------------------------------------------------1--------------------------#-------#####---------------------------------------1-------------------------
--------tt---------------------------------tt---------#--#-------#-----------------SU-tt------------SS!S-------------------##------######--S--#-------#----------------------------------SS!S-------------
--------tt---------------------------------tt--------##--##------##-------------------tt----------------------------------###-----#######-----##------##------------------#----------------------tt-------
--------tt---------------------------------tt-------###--###-----###------------------tt-----------------------tt-########----tt-#------------###-----###------tt-########-----------------------tt-------
-M--g-g-tt-----------------------------g-g-tt-g----####--####----####---------g-g-----tt------------------gg---tt#########----tt##-g----####--####----####-----tt#########---------------------ggtt-g-----
XXXXXXXXXXXXXXXXXXXXXXXXX--XXXXXXXXX--XXXXXXXXXXXXXXXXXXXXXXXXXX-XXXXXXXXXXXXXXXXXXXXXXXXXXXXXXXXXXXXXXXXXXXXXXXXXXXXXXXXXXXXXXXXXXXXXXXXXXXXXXXXXXXX-XXXXXXXXXXXXXXXXXXXXXXXXXXXXXXXXXXXXXXXXXXXXXXXXXXXX
XXXXXXXXXXXXXXXXXXXXXXXXX--XXXXXXXXX--XXXXXXXXXXXXXXXXXXXXXXXXXX-XXXXXXXXXXXXXXXXXXXXXXXXXXXXXXXXXXXXXXXXXXXXXXXXXXXXXXXXXXXXXXXXXXXXXXXXXXXXXXXXXXXX-XXXXXXXXXXXXXXXXXXXXXXXXXXXXXXXXXXXXXXXXXXXXXXXXXXXX
