----------------------------------------------------------------------------------------------------------------------------------------------------------------------------------------------------------
----------------------------------------------------------------------------------------------------------------------------------------------------------------------------------------------------------
----------------------------------------------------------------------------------------------------------------------------------------------------------------------------------------------------------
----------------------------------------------------------------------------------------------------------------------------------------------------------------------------------------------------------
----------------------------------------------------------------------------------------------------------------------------------------------------------------------------------------------------------
----------------------------------------------------------------------------------------------------------------------------------------------------------------------------------------------------------
----------------------------------S----!--SSS!-----------------------------------------------------------------------------------------SSS!---------------------------------------------------------------
----------------------------------------------------------------------------------------------------------------------------------------------------------------------------------------------------------
---------------------------------g------------------------------------------------------------------------------------------------------------------------------------------------------------------------
------------------------------------------------------------1---------------------------------------------------------------------------------------------------------------------------------------------
------------S--------------!---S@S---S@S!-----------!---------------------!--------------ttSS!S-----------------------------------S---------------C-------SS!S---------------------!-------!-S------------
-----------------------------------------------------------------------------------------tt---------------------------------------------------------------------------------------------------------------
-------------------------------------------------------------------------------tt--------tt--------------------------tt-#-----------------------------------------------------------------------XTT-------
-M----------------gg-g----------------g-------------k---------------------k----tt----g-g-tt------gg------------------tt##---------------gg-g--------------------gg-----------------k-------------tt-------
XXXXXXXXXXXXXXXXXXXXXXXXXXXXXXXXXXXXXXXXXXXXXX--XXXXXXXXXXXXXXXXXXXXXXXXXXXXXXXXXXXXXXXXXXXXXXXXXXXXX--XXXXXXXXX--XXXXXXXXXXXXXXXXXXXXXXXXXX-XXXXXXXXXXXXXXXXXXXXXXXXXXXXXXXXXXXXXXXXXXXXXXXXXXXXXXXXXXXXX
XXXXXXXXXXXXXXXXXXXXXXXXXXXXX------------XXXXX--XXXXXXXXXXXXXXXXXXXXXXXXXXXXXXXXXXXXXXXXXXXXXXXXXXXXX--XXXXXXXXX--XXXXXXXXXXXXXXXXXXXXXXXXXX-XXXXXXXXXXXXXXXXXXXXXXXXXXXXXXXXXXXXXXXXXXXXXXXXXXXXXXXXXXXXX
