----------------------------------------------------------------------------------------------------------------------------------------------------------------------------------------------------------
----------------------------------------------------------------------------------------------------------------------------------------------------------------------------------------------------------
----------------------------------------------------------------------------------------------------------------------------------------------------------------------------------------------------------
----------------------------------------------------------------------------------------------------------------------------------------------------------------------------------------------------------
----------------------------------------------------------------------------------------------------------------------------------------------------------------------------------------------------------
------------------------------------------------------------------------------------------------g---------------------------------------------------------------------------------------------------------
--------------------------------------------------------------------------!------S-------------SSSSSSS----------------------------------------------------------------------------------------------------
---------------------------------g------------------------------------------------------------------------------------------------------------------------------------------------------------------------
-----------SSS!-----------------SSSSSSS-----------------------------------------g------------------------------------------------------------------------------SSS!---------------------------------------
-----------------------1-----------------------------------------------------------------------------------------------------------------------------------1----------------------------1-----------------
--------t-------------------------------------tt------------tt----------S@S!--S@S-------------tt------C---------#--#-------#-----------------tt------C-----------------------tt---------------------S-----
--------t-------------------------------------tt------------tt--------------------------------tt---------------##--##------##----------------tt------------------------------tt---------------------------
--------tt#######----------------#######------tt---tt-#-----tt--------------------------------tt--------------###--###-----###-----tt--------tt---------------#######--------tt---------------------------
-M--g-g-tt#######----------------#######--g-g-tt---tt##-g-g-tt-----------g----------------g-g-tt-------------------####----####----tt----g-g-tt---------------#######--------tt---------------------------
XXXXXXXXXXXXXXXXXXXXXXXXXX-XXXXXXXXXXXXXXXXXXXXXXXXXXXXXXXXXXXXX--XXXXXXXXXXXXXXXXXXXXX--XXXXXXX-XXXXXXXXXXXXXXXXXXXXXXXXX-XXXXXXXXXXXXXXXXXXXX-XXXXXXXXXXXXXXXXXXXXXXXXXXXXXXXXXXXXXXXXXXXXXXXXXXXXXXXXXX
XXXXXXXXXXXXXXXXXXXXXXXXXX-XXXXXXXXXXXXXXXXXXXXXXXXXXXXXXXXXXXXX--XXXX------------XXXXX--XXXXXXX-XXXXXXXXXXXXXXXXXXXXXXXXX-XXXXXXXXXXXXXXXXXXXX-XXXXXXXXXXXXXXXXXXXXXXXXXXXXXXXXXXXXXXXXXXXXXXXXXXXXXXXXXX
