----------------------------------------------------------------------------------------------------------------------------------------------------------------------------------------------------------
----------------------------------------------------------------------------------------------------------------------------------------------------------------------------------------------------------
----------------------------------------------------------------------------------------------------------------------------------------------------------------------------------------------------------
----------------------------------------------------------------------------------------------------------------------------------------------------------------------------------------------------------
----------------------------------------------------------------------------------------------------------------------------------------------------------------------------------------------------------
--------------------------------------------------------------------------------------------------------------------------------------------------------g-------------------------------------------------
-SSS!-----------------------------------------------------------------S--------------------------------------------------------------------------------SSSSSSS--------------------------------------------
----------------------------------------------------------------------------------------------------------------------------------------------------------------------------------------------------------
---------------------------------------------------------------------g------------------------------------------------------------------------------------------------------------------------------------
-----------------------------------------------------------------------------------------------------------------------------------------------------1----------------------------------------------------
--------SU------C---------#--------------------!-------------------S@S-S---------------#--#-------#--------------S--#----------##--#------tt----------------!-----------#--#----------##--#---------------
-------------------------##-----------------------------------------------------------##--##------##----------------##--------###--##-----tt---------------------------##--##--------###--##--------------
------------------------###-----------------------------------------------XTT--------###--###-----###---------------###------####--###----tt--------------------------###--###------####--###-------------
-M-g-g------------g----####-----gg-g-----------k---------------------------tt--g----####--####----####--------------####----#####--####---tt----------------k--------------####----#####--####------------
XXXXXXXXXX-XXXXXXXXXXXXXXXXXXXXXXXXXXXXXXXXXXXXXXXXXXXXXXXX--XXXXXXXXXXXXXXXXXXXXXXXXXXXXXXXXXXXX-XXXXXXXXXXXXXXXXXXXXXXXXXXXXXXX--XXXXXXXXXXXXXXXXXXXXXXXXXXXXXXXXXXXXXXXXXXXXXXXXXXXXX--XXXXXXXXXXXXXX--
XXXXXXXXXX-XXXXXXXXXXXXXXXXXXXXXXXXXXXXXXXXXXXXXXXXXXXXXXXX--XXXX------XXXXXXXXXXXXXXXXXXXXXXXXXX-XXXXXXXXXXXXXXXXXXXXXXXXXXXXXXX--XXXXXXXXXXXXXXXXXXXXXXXXXXXXXXXXXXXXXXXXXXXXXXXXXXXXX--XXXXXXXXXXXXXX--
