----------------------------------------------------------------------------------------------------------------------------------------------------------------------------------------------------------
----------------------------------------------------------------------------------------------------------------------------------------------------------------------------------------------------------
----------------------------------------------------------------------------------------------------------------------------------------------------------------------------------------------------------
----------------------------------------------------------------------------------------------------------------------------------------------------------------------------------------------------------
----------------------------------------------------------------------------------------------------------------------------------------------------------------------------------------------------------
----------------------------------------------------------------------------------------------------------------------------------------------------------------------------------------------------------
-------------------------------------------------------------!--------------------S--------------------------------------------------------------------@----------------!------S--------------------------
----------------------------------------------------------------------------------------------------------------------------------------------------------------------------------------------------------
---------------------------------------------------------------------------------g--------------------------------------------------------------------------------------------g---------------------------
----------------------------------------------------------------------------------------------------------------------------------------------------------------------------------------------------------
--------------------------------S--#-------#---------------S@S!S-----------!---S@S-S---------------S--#----------##--#---------------------#--------------SU----------S@S!--S@S-S----------------------#--
-----------------------------------##------##---------------------------------------------------------##--------###--##-------------------##----------------------------------------------------------##--
-----tt-----------tt---------------###-----###--------------------XTT-----------------XTT-------------###------####--###-----------------###---------------------------------------XTT---------------###--
-M---tt-----------tt---------------####----####-------------g------tt------------------tt--g----####--####----#####--####------------------------gg-gg-g---------------g------------tt--------------------
XXXXXXXXXXXXXXXXXXXXXXXXXXXXXXXXXXXXXXXXXX-XXXXXXXX--XXXXXXXXXXXXXXXXXXXXXXXXXXXXXXXXXXXXXXXXXXXXXXXXXXXXXXXXXXXXXX--XXXXXXXXXXXXXXXXXXXXXXXXXXXXXXXXXXXXXXXXX--XXXXXXXXXXXXXXXXXXXXXXXXXXXXXXXXXXXXXXXXXX
XXXXXXXXXXXXXXXXXXXXXXXXXXXXXXXXXXXXXXXXXX-XXXXXXXX--XXXX------XXXXXXXXXXXXXX------XXXXXXXXXXXXXXXXXXXXXXXXXXXXXXXX--XXXXXXXXXXXXXXXXXXXXXXXXXXXXXXXXXXXXXXXXX--XXXX------------XXXXXXXXXXXXXXXXXXXXXXXXXX
