----------------------------------------------------------------------------------------------------------------------------------------------------------------------------------------------------------
----------------------------------------------------------------------------------------------------------------------------------------------------------------------------------------------------------
----------------------------------------------------------------------------------------------------------------------------------------------------------------------------------------------------------
----------------------------------------------------------------------------------------------------------------------------------------------------------------------------------------------------------
----------------------------------------------------------------------------------------------------------------------------------------------------------------------------------------------------------
----------------------------------------------------------------------------------------------------------------------------------------------------------------------------------------------------------
---------------S----!------S------------------------------------@-------------------------------------!------S--------------------------------------------------------------------------------------------
----------------------------------------------------------------------------------------------------------------------------------------------------------------------------------------------------------
--------------g-----------g-------------------------------------------------@-------------------------------g---------------------------------------------------------------------------------------------
----------------------------------------------------------------------------------1-----------------------------------------------------------------------------------------------------------------------
--------!---S@S---S@S!--S@S--------------------!-------------------SU---------------------------!---S@S!--S@S-------------tt----------------------------------SS!S-------------S--------------------------
--------------------------------------------------------------------------------------------------------------------------tt------------------------------------------------------------------------------
---------------------------------------------------------------------#######----------------------------------------------tt--tt------------tt-#---------tt---------------------------------tt-########---
-M-----------------g------------------------------------------g-g----#######-------------------------g----------------g-g-tt--tt------------tt##---------tt---------gg---------------gg-g---tt#########---
XXXXXXXXXXXXXXXXXXXXXXXXXXXXXXXXX--XXXXXXXXXXXXXXXXXXX--XXXXXXXXXXXXXXXXXXXXXXXXXXXXXXXXXXXXXXXXXXXXXXXXXXXXXXXXXXX--XXXXXXXXXXXXXXXXXXXXXXXXXXXXXXXXXXXXXXXXXXXXXXXXXXXXXXXXXXXXXXXXXXXXXXXXXXXXXXXXXXXXX
XXXXXXXXXX------------------XXXXX--XXXXXXXXXXXXXXXXXXX--XXXXXXXXXXXXXXXXXXXXXXXXXXXXXXXXXXXXXXXXXX------------XXXXX--XXXXXXXXXXXXXXXXXXXXXXXXXXXXXXXXXXXXXXXXXXXXXXXXXXXXXXXXXXXXXXXXXXXXXXXXXXXXXXXXXXXXX
