----------------------------------------------------------------------------------------------------------------------------------------------------------------------------------------------------------
----------------------------------------------------------------------------------------------------------------------------------------------------------------------------------------------------------
----------------------------------------------------------------------------------------------------------------------------------------------------------------------------------------------------------
----------------------------------------------------------------------------------------------------------------------------------------------------------------------------------------------------------
----------------------------------------------------------------------------------------------------------------------------------------------------------------------------------------------------------
----g-----------------------------------------------------------------------------------------------------------------------------------------------------------------------------------------------------
SSSSSSSSSS--------------------S---------------------------------------S!!S--------------------------------------------------------------------------------------------------------------------------------
----------------------------------------------------------------------------------------------------------------------------------------------------------------------------------------------------------
-----------------------------g-----------------------SSS!-------------------------------------------------------------------------------------------------------------------------------------------------
-----------------------------------------------------------------1----------------------------------------------------------------------------------------------------------------------------------------
--------SU------C----------S@S-------------------------------------------SU-------SS!S-------------S--#----------##--#--------------#--#----------##--#------------------SS!S-------------#--------------t
------------------------------------------------------------------------------------------------------##--------###--##------------##--##--------###--##----tt---------------------------##--------------t
------------------------------------------------tt-########-------------------------------------------###------####--###----------###--###------####--###---tt--------------------------###--------------t
-M-g-g------------------------------------------tt#########---------g-g-----------------gg-g----####--####----#####--####---g----####--####----#####--####--tt-g---------------gg-g----####-----gg-g-g-g-t
XXXXXXXXXX-XXXXXXXX--XXXXXXXXXXXXXXX--XXXXXXXXXXXXXXXXXXXXXXXXXXXXXXXXXXXXXXXXXXXXXXXXXXXXXXXXXXXXXXXXXXXXXXXXXXXXX--XXXXXXXXXXXXXXXXXXXXXXXXXXXXXXX--XXXXXXXXXXXXXXXXXXXXXXXXXXXXXXXXXXXXXXXXXXXXXXXXXXXX
XXXXXXXXXX-XXXXXXXX--XXXX------XXXXX--XXXXXXXXXXXXXXXXXXXXXXXXXXXXXXXXXXXXXXXXXXXXXXXXXXXXXXXXXXXXXXXXXXXXXXXXXXXXX--XXXXXXXXXXXXXXXXXXXXXXXXXXXXXXX--XXXXXXXXXXXXXXXXXXXXXXXXXXXXXXXXXXXXXXXXXXXXXXXXXXXX
