----------------------------------------------------------------------------------------------------------------------------------------------------------------------------------------------------------
----------------------------------------------------------------------------------------------------------------------------------------------------------------------------------------------------------
----------------------------------------------------------------------------------------------------------------------------------------------------------------------------------------------------------
----------------------------------------------------------------------------------------------------------------------------------------------------------------------------------------------------------
----------------------------------------------------------------------------------------------------------------------------------------------------------------------------------------------------------
---------------------------------------------------------------------------------------------------------------------------------------------------------------------------g------------------------------
--------------------------SSS!-----------------!------S-------------------------------------------------------------------------------------------------------------------SSSSSSS-------------------------
----------------------------------------------------------------------------------------------------------------------------------------------------------------------------------------------------------
-----------------------------------------------------g----------------------------------------------------------------------------------------------------------------------------------------------------
-----------------------------------------------------------------------------------------------------------------------------------------------------------------------------------------------1----------
------------------#--------------SU----------S@S!--S@S-S-----------tt-tt-------------S--#----------##--#----------------------------#--#----------##--#---------------------------SS!S--------------------
-----------------##------------------------------------------------tt-tt----------------##--------###--##----tt--------------------##--##--------###--##--------------------------------------------------
----------------###---------------------------------------XTT------tt-tt----------------###------####--###---tt-------------------###--###------####--###-------------------------------------------------
-M--------g----####-----gg-gg-g---------------g------------tt--g-g-tt-tt----------------####----#####--####--tt-g-----------g----####--####----#####--####------------------------------gg----------------
XXXXXXXXXXXXXXXXXXXXXXXXXXXXXXXXXXXXX--XXXXXXXXXXXXXXXXXXXXXXXXXXXXXXXXXXXXXXXXXXXXXXXXXXXXXXXXXXXXXX--XXXXXXXXXXXXXXXXXXXXXXXXXXXXXXXXXXXXXXXXXXXXX--XXXXXXXXXXXXXXX--XXXXXXXXX--XXXXXXXXXXXXXXXXXXXXXXXX
XXXXXXXXXXXXXXXXXXXXXXXXXXXXXXXXXXXXX--XXXX------------XXXXXXXXXXXXXXXXXXXXXXXXXXXXXXXXXXXXXXXXXXXXXX--XXXXXXXXXXXXXXXXXXXXXXXXXXXXXXXXXXXXXXXXXXXXX--XXXXXXXXXXXXXXX--XXXXXXXXX--XXXXXXXXXXXXXXXXXXXXXXXX
