----------------------------------------------------------------------------------------------------------------------------------------------------------------------------------------------------------
----------------------------------------------------------------------------------------------------------------------------------------------------------------------------------------------------------
----------------------------------------------------------------------------------------------------------------------------------------------------------------------------------------------------------
----------------------------------------------------------------------------------------------------------------------------------------------------------------------------------------------------------
------------------------------------------------------------------##--------------------------------------------------------------------------------------------------------------------------------------
-----------------------------------------------------------------###--------------------------------------------------------------------------------------------------------------------------------------
----------------------------------------------------------------####---------------------------------------------------------------------SSS!-------------------------------------------------------------
---------------------------------------------------------------#####----------------------------------------------------------------------------------g----------S----------------------------------------
--------------------------------------------------------------######---------------------------------------------------------------------------------SSSSSSS----------------------------------------------
--------1--------------1-------------------------------------#######----------------------------------------------1---------------------------------------------------------------------------------------
------------tt----------------------------#--#-------#----------tt-----SU---------tt----------------!-S------------------------------#-------------!----------------CSS!S----------CSS!S-------------#--#-
------------tt---------------------------##--##------##---------tt--------------#-tt---------------------------------tt-------------##--------------------------------------------------------------##--##
------------tt--------------------------###--###-----###--------tt-------#######--tt---------------------XTT---------tt------------###----------------#######--------------------------------------###--##
-M----------tt--------------------g----####--####----####---g-g-ttg-g----#######--tt----------------------tt---------tt-g------------------gg-g----k--#######--------------gg-------------gg------------##
XXXXXXXXXXXXXXXXXXXXXXXXXXXXXXXXXXXXXXXXXXXXXXXXXXXX-XXXXXXXXXXXXXXXXXXXXXXXXXXXXXXXXXXXXXXXXXXXXXXXXXXXXXXXXXXXXXXXXXXXXXXXXXXXXXXXXXXXXXXXXXXXXXXXXXXXXXXXXX-XXXXXXXXXXXXXX-XXXXXXXXXXXXXXXXXXXXXXXXXXXX
XXXXXXXXXXXXXXXXXXXXXXXXXXXXXXXXXXXXXXXXXXXXXXXXXXXX-XXXXXXXXXXXXXXXXXXXXXXXXXXXXXXXXXXXXXXXXXXXXXXXXXXXXXXXXXXXXXXXXXXXXXXXXXXXXXXXXXXXXXXXXXXXXXXXXXXXXXXXXX-XXXXXXXXXXXXXX-XXXXXXXXXXXXXXXXXXXXXXXXXXXX
