----------------------------------------------------------------------------------------------------------------------------------------------------------------------------------------------------------
----------------------------------------------------------------------------------------------------------------------------------------------------------------------------------------------------------
----------------------------------------------------------------------------------------------------------------------------------------------------------------------------------------------------------
----------------------------------------------------------------------------------------------------------------------------------------------------------------------------------------------------------
----------------------------------------------------------------------------------------------------------------------------------------------------------------------------------------------------------
-------------------------g------------------------------------------------------------------------------g-------------------------------------------------------------------------------------------------
SSSSS-------------------SSSSSSS------------------------------------S-----------------------------------SSSSSSS---------------------------------------------------------SSS!-------------------------------
----------------------S-----------------------------------------------------------------------------------------------------------------------------------------------------------------------------------
------------------------------------------------------------------g-------------------------------------------------------------------------------------------------g-------------------------------------
---------------1----------------------------1-------------------------------------------------------------------------------------------------------------------------------------------------------------
--------SU-------------SU------C----!---------------------------S@S----------------------------CSS!S----------C---------#-----------------S-------tt--------------S@S------------!------------------#-----
----------------------------------------------------------------------------------tt-----------------------------------##-------------------------tt-----------------------------------------------##-----
-------------------------------------------------tt---------------------------tt-#tt----------------------------------###--------------------XTT--tt----------------------------------------------###-----
-M-g-g------------g-g---------------k------------tt---------------------------tt##tt-g----------------gg--------g----####-----gg-g------------tt--tt-----------------------------k------------------------
XXXXXXXXXXXXXXXXXXXXXXXXX-XXXXXXXXXXXXXXXXXXXXXXXXXXXXXX--XXXXXXXXXXXXXXX--XXXXXXXXXXXXXX-XXXXXXXXXXXXXX-XXXXXXXXXXXXXXXXXXXXXXXXXXX--XXXXXXXXXXXXXXXXXXXX--XXXXXXXXXXXXXXX--XXXXXXXXXXXXXXXXXXXXXXXXXXXXX
XXXXXXXXXXXXXXXXXXXXXXXXX-XXXXXXXXXXXXXXXXXXXXXXXXXXXXXX--XXXX------XXXXX--XXXXXXXXXXXXXX-XXXXXXXXXXXXXX-XXXXXXXXXXXXXXXXXXXXXXXXXXX--XXXXXXXXXXXXXXXXXXXX--XXXX------XXXXX--XXXXXXXXXXXXXXXXXXXXXXXXXXXXX
