----------------------------------------------------------------------------------------------------------------------------------------------------------------------------------------------------------
----------------------------------------------------------------------------------------------------------------------------------------------------------------------------------------------------------
----------------------------------------------------------------------------------------------------------------------------------------------------------------------------------------------------------
----------------------------------------------------------------------------------------------------------------------------------------------------------------------------------------------------------
----------------------------------------------------------------------------------------------------------------------------------------------------------------------------------------------------------
----------------------------------------------------------------------------------------------------------------------------------------------------------------------------------------------------------
------------------------------------------------------------------------------SS--SSS!------------------------------------------------------------------------------------------------------!------S------
--------------------------------------------------------------------------------------------------------------------------------------------------------------#-------------------------------------------
-------------------------------------------------------------------------------------------------------------------------------------------------------------##-----------------------------------g-------
---------------------------------------------------------------------------------------------------------------------------------1--------------1-----------###--------------1----------------------------
----tt--------------------S--#-------#-----SS!S----------------tt---------S--------------SU----------------S---------------------------------------------------SU-------------------------S@S!--S@S-------
----tt-----------------------##------##------------------------tt--------------------------tt------------------------tt----------------------------tt-----------------------------------------------------
----tt------tt---------------###-----###-------------tt--------tt--------------------------tt------------------------tt----------------------------tt---------------tt-#----------------------------------
-M--tt------tt---------------####----####--------gg--tt----g-g-tt---------------gg-gg-g----tt-g------------------gg-gtt-g--------------------------tt-g---g-g-------tt##-------------------g--------------
XXXXXXXXXXXXXXXXXXXXXXXXXXXXXXXXXXXX-XXXXXXXXXXXXXXXXXXXXXXXXXXXXXXXXXXXXXXXXXXXXXXXXXXXXXXXXXXXXXXXXXXXXXXXXXXXXXXXXXXXXXXXXXXXXXXXXXXXXXXXXXXXXXXXXXXXXXXXXXXXXXXXXXXXXXXXXXXXXX--XXXXXXXXXXXXXXXXXXXXX-
XXXXXXXXXXXXXXXXXXXXXXXXXXXXXXXXXXXX-XXXXXXXXXXXXXXXXXXXXXXXXXXXXXXXXXXXXXXXXXXXXXXXXXXXXXXXXXXXXXXXXXXXXXXXXXXXXXXXXXXXXXXXXXXXXXXXXXXXXXXXXXXXXXXXXXXXXXXXXXXXXXXXXXXXXXXXXXXXXX--XXXX------------XXXXX-
