----------------------------------------------------------------------------------------------------------------------------------------------------------------------------------------------------------
----------------------------------------------------------------------------------------------------------------------------------------------------------------------------------------------------------
----------------------------------------------------------------------------------------------------------------------------------------------------------------------------------------------------------
----------------------------------------------------------------------------------------------------------------------------------------------------------------------------------------------------------
----------------------------------------------------------------------------------------------------------------------------------------------------------------------------------------------------------
----------------------------------------------------------------------------------------------------------------------------------------------------------------------------------------------------------
-----@---------------------------------------------------------------------------------SSS!---------------------------------------------------!-----------------------------------------------------------
----------------------------------------------------------------------------------------------------------------------------------------------------------------------------------------------------------
----------------------------------------------------------------------------------------------------------------------------------------------------------------------------------------------------------
-------------------------------------------------------------------------------------------------------------------------1--------------------------------------------------------------------------------
--------SU-tt---------tt------SS!S------------S-------tt-------------S--#-------#-----------C--------SS!S-----------------------------------S@S!S-----------ttSS!S-----------SS!S-----------------SS!S----
-----------tt---------tt------------------------------tt----------------##------##------------------#-------------------------------------------------------tt--------tt----------------------------------
-----------tt---------tt-------------------------XTT--tt----------------###-----###----------#######-----------------------------------------------XTT------tt--------tt----------------------------------
-M-g-g-----tt-----g-g-tt------------gg------------tt--tt-----g----####--####----####---------#######-------gg--------------------------------g------tt--g-g-tt------ggtt-g---------gg-------------------gg
XXXXXXXXXXXXXXXXXXXXXXXXXXXXXXXXXXXXXXXX--XXXXXXXXXXXXXXXXXXXXXXXXXXXXXXXXXXXXX-XXXXXX-XXXXXXXXXXXXXXXXXXXXXXXXXXXXXXXXXXXXXXXXXXXXX--XXXXXXXXXXXXXXXXXXXXXXXXXXXXXXXXXXXXXXXXXXXXXXXXXXXXXXXXXXXXXXXXXXXX
XXXXXXXXXXXXXXXXXXXXXXXXXXXXXXXXXXXXXXXX--XXXXXXXXXXXXXXXXXXXXXXXXXXXXXXXXXXXXX-XXXXXX-XXXXXXXXXXXXXXXXXXXXXXXXXXXXXXXXXXXXXXXXXXXXX--XXXX------XXXXXXXXXXXXXXXXXXXXXXXXXXXXXXXXXXXXXXXXXXXXXXXXXXXXXXXXXX
