----------------------------------------------------------------------------------------------------------------------------------------------------------------------------------------------------------
----------------------------------------------------------------------------------------------------------------------------------------------------------------------------------------------------------
----------------------------------------------------------------------------------------------------------------------------------------------------------------------------------------------------------
----------------------------------------------------------------------------------------------------------------------------------------------------------------------------------------------------------
----------------------------------------------------------------------------------------------------------------------------------------------------------------------------------------------------------
----------------------------------------------------------------------g------g----------------------------------------------------------------------------------------------------------------------------
----------------------------!----------------------------------------SSSSSSSSSSSSSS-----------------------------------------------------------------------------------------------------------------------
----------------------------------------#-----------------------------------------------------------------------------------------------------------------------------------------------------------------
---------------------------------------##-----------------------------------------------------------------------------------------------------------------------------------------------------------------
--------------------------------------###-----------------------------------------------------------------------------------------------1-----------------------------------------------------------------
----tt----------------!---S@S!-------------C---------#--------------tt------C----!-----------S-----------------------------SS!S-----------------!-S------SS!S----------C----!-----------------------------
----tt----------------------------------------------##--------------tt------------------------------------------------------------------------------------------------------------------------------------
----tt---------------------------------------------###--------------tt------------------------------------------------tt-----------------------------XTT-------------------------------------#######------
-M--tt---------------------g-----------------g----####-----gg-g-g-g-tt-----------k---g----####-----gg-g---------------tt---------gg-------------------tt-------gg-----------k----------------#######------
XXXXXXXXXXXXXXXXXXXXXXXXXXXXXXXXXXX---XXXXXXXXXXXXXXXXXXXXXXXXXXXXXXXX-XXXXXXXXXXXXXXXXXXXXXXXXXXXXXXXXXXXXXXXXXXXXXXXXXXXXXXXXXXXXXXXXXXXXXXXXXXXXXXXXXXXXXXXXXX-XXXXXXXXXXXXXXXXXXXXXXXXXXXXXXXXXXXXX--X
XXXXXXXXXXXXXXXXXXXXXXXX------XXXXX---XXXXXXXXXXXXXXXXXXXXXXXXXXXXXXXX-XXXXXXXXXXXXXXXXXXXXXXXXXXXXXXXXXXXXXXXXXXXXXXXXXXXXXXXXXXXXXXXXXXXXXXXXXXXXXXXXXXXXXXXXXX-XXXXXXXXXXXXXXXXXXXXXXXXXXXXXXXXXXXXX--X
