----------------------------------------------------------------------------------------------------------------------------------------------------------------------------------------------------------
----------------------------------------------------------------------------------------------------------------------------------------------------------------------------------------------------------
----------------------------------------------------------------------------------------------------------------------------------------------------------------------------------------------------------
----------------------------------------------------------------------------------------------------------------------------------------------------------------------------------------------------------
----------------------------------------------------------------------------------------------------------------------------------------------------------------------------------------------------------
----------------------------------------------------------------------------------------------------------------------------------------------------------------------------------------------------------
-----------------------------------S----!-----------------------------------------------------------------------------------------------------------------------------------------------------------------
--------------------------------------------------------------------------------------g-------------------------------------------------------------------------------------------------------------------
----------------------------------g--------------------------------------------------SSSSSSS--------------------------------------------------------------------------------------------------------------
------------------------------------------------------1---------------------------------------------------------------------------------------------------------------------------------------------------
-------!------------!-------!---S@S---S@S!---------------SS!S---------!----------------------------------tt-----SU-----tt----------------#---------------------ttSS!S---------------------#---------------
---------------------------------------------------------------------------------------------------------tt------------tt---------------##---------tt----------tt------------------------##---------------
-------------------------------------------------------------------------------------#######-------------tt------------tt--tt----------###---------tt----------tt--------#######--------###---------------
-M-----k------------k------------------g-----------------------gg--------------------#######---------g-g-ttg-g-----g-g-tt--tt------------------gg-gtt-g----g-g-tt------gg#######----------------gg-g------
XXXXXXXXXXXXXXXXXXXXXXXXXXXXXXXXXXXXXXXXXXXXXXX--XXXXXXXXXXXXXXXXXXXXXXXXXXXX--XXXXXXXXXXXXXXXXXXXXXXXXXXXXXXXXXXXXXXXXXXXXXXXXXXXXXXXXXXXXXXXXXXXXXXXXXXXXXXXXXXXXXXXXXXXXXXXXXXXXXXXXXXXXXXXXXXXXXXX--XX
XXXXXXXXXXXXXXXXXXXXXXXXXXXXXX------------XXXXX--XXXXXXXXXXXXXXXXXXXXXXXXXXXX--XXXXXXXXXXXXXXXXXXXXXXXXXXXXXXXXXXXXXXXXXXXXXXXXXXXXXXXXXXXXXXXXXXXXXXXXXXXXXXXXXXXXXXXXXXXXXXXXXXXXXXXXXXXXXXXXXXXXXXX--XX
