----------------------------------------------------------------------------------------------------------------------------------------------------------------------------------------------------------
----------------------------------------------------------------------------------------------------------------------------------------------------------------------------------------------------------
----------------------------------------------------------------------------------------------------------------------------------------------------------------------------------------------------------
----------------------------------------------------------------------------------------------------------------------------------------------------------------------------------------------------------
----------------------------------------------------------------------------------------------------------------------------------------------------------------------------------------------------------
----------------------------------------------------------------------------------------------------------------------------------------------------------------------------------------------------------
----------------------------------------SSS!--------------------------------------------------------------------------SSS!-------##-------------S---------------------------------------------------------
--------------------------------------------------------------------------------------------------------------------------------###-----------------------------------------------------------------------
-------------------------------------------------------------------------------------------------------------------------------####------------g----------------------------------------------------------
------------------------------------------------------------------------------------------------------------------------------#####-----------------------------------------------------------------------
------------------S----------------------------SU-------SS!S--------------------------#--------------------!-------------!---######------!---S@S-S---------------S---------SS!S-------------#-------------
-------------------------------------------------------------------------------------##---------tt--------------------------#######--------------------------------------------------------##-------------
-------------------------------------tt-------------tt-#-----------------tt-#-------###---------tt--------------------------#######-----------------XTT-----------------------------------###-------------
-M--------g----####-----gg-g---------tt---g-g-------tt##------gg---------tt##-g----####-----gg-gtt-g-------k-------------k--#######------------------tt----------------gg-g------gg---------------gg-g----
XXXXXXXXXXXXXXXXXXXXXXXXXXXXXXXXXXXXXXXXXXXXXXXXXXXXXXXXXXXXXXXXXXXXXXXXXXXXXXXXXXXXXXXXXXXXXXXXXXXXXXXXXXXXXXXXXXXXXXXXXXXXXXXXXXXXXXXXXXXXXXXXXXXXXXXXXXXXXXXXXXXXXXXXXXXXXXXXXXXXXXXXXXXXXXXXXXXXXX-XXX
XXXXXXXXXXXXXXXXXXXXXXXXXXXXXXXXXXXXXXXXXXXXXXXXXXXXXXXXXXXXXXXXXXXXXXXXXXXXXXXXXXXXXXXXXXXXXXXXXXXXXXXXXXXXXXXXXXXXXXXXXXXXXXXXXXXXXXXXXXX------XXXXXXXXXXXXXXXXXXXXXXXXXXXXXXXXXXXXXXXXXXXXXXXXXXXXX-XXX
