----------------------------------------------------------------------------------------------------------------------------------------------------------------------------------------------------------
----------------------------------------------------------------------------------------------------------------------------------------------------------------------------------------------------------
----------------------------------------------------------------------------------------------------------------------------------------------------------------------------------------------------------
----------------------------------------------------------------------------------------------------------------------------------------------------------------------------------------------------------
----------------------------------------------------------------------------------------------------------------------------------------------------------------------------------------------------------
----------------------------------------------------------------------------------------------------------------------------------------------------------------------------------------------------------
-----------------------------------S------------------------------------------------------------------------------------------------##--------------------------------------------------------------------
-----------------------------------------------------------------------------------------------------------------------------------###--------------------------------------------------------------------
----------------------------------g-----------------------------------------------------------------------------------------------####--------------------------------------------------------------------
---------------------------------------------------------------------------------------------------------------------1-----------#####---------------------------------------------S---1------------------
-------!---tt---------------!---S@S-S------SS!S-------------------------------C--------------------------C-------------------tt-######--tt---------------------------------------------------------#--#---
-----------tt----------------------------------------------------------------------------------------------------------------tt#######--tt-----------tt-------------------------------------------##--##--
-----------tt--------------------------XTT----------------------------------------------tt-#---------------------------------tt#######--tt------tt---tt---------------tt-########----------------###--###-
-M-----k---tt---------------------------tt-------gg-------------------------------------tt##-----------------------------g-g-tt#######--tt------tt---tt-g-------------tt#########----------g----####--####
XXXXXXXXXXXXXXXXXXXXXXXXXXXXXXXXXXXXXXXXXXXXXXXXXXXXXXXXXXXXXXXXXXXXXXXX-XXXXXXXXXXXXXXXXXXXXXXXXXX-XXXXXXXXXXXXXXXXXXXXXXXXXXXXXXXXXXXXXXXXXXXXXXXXXXXXXXXXXXXXXXXXXXXXXXXXXXXXXXXXXXXXXXXXXXXXXXXXXXXXXX
XXXXXXXXXXXXXXXXXXXXXXXXXXXXXX------XXXXXXXXXXXXXXXXXXXXXXXXXXXXXXXXXXXX-XXXXXXXXXXXXXXXXXXXXXXXXXX-XXXXXXXXXXXXXXXXXXXXXXXXXXXXXXXXXXXXXXXXXXXXXXXXXXXXXXXXXXXXXXXXXXXXXXXXXXXXXXXXXXXXXXXXXXXXXXXXXXXXXX
