----------------------------------------------------------------------------------------------------------------------------------------------------------------------------------------------------------
----------------------------------------------------------------------------------------------------------------------------------------------------------------------------------------------------------
----------------------------------------------------------------------------------------------------------------------------------------------------------------------------------------------------------
----------------------------------------------------------------------------------------------------------------------------------------------------------------------------------------------------------
----------------------------------------------------------------------------------------------------------------------------------------------------------------------------------------------------------
----------------------------------------------------------------------------------------------------------------------------------------------------------------------------------------------------------
------------S!!S-------------------------------------SSS!-------------------------------------------------------------------------------------------------------------------------------------------------
-------------------------------------------------------------------------------------------------------------------------------------#--------------------------------------------------------------------
------------------------------------------------------------------------------------------------------------------------------------##--------------------------------------------------------------------
-----------------------------------------------------------------------------------------------------------------------------------###--------------------------------------------------------------------
---------------SU-tt---------tt-------------------------!--------------------------S--#----------##--#-------------------C------------SU----!---------SS!S-----tt---------!-S--------------------------tt-
------------------tt---------tt-------tt---------------------------tt-----------------##--------###--##--------------------------------------------------------tt--------------------------------------tt-
------------------tt---------tt-------tt-------tt----------#######-tt-----------------###------####--###---#######-------------------------------tt------------tt--------------XTT--------#######------tt-
-M--------g-g-----tt-----g-g-tt-------tt-g-----tt-------k--#######-tt-g---------------####----#####--####--#######---------------g-g--------k----tt---------gg-tt---------------tt--------#######--g-g-tt-
XXXXXXXXXXXXXXXXXXXXXXXXXXXXXXXXXXXXXXXXXXXXXXXXXXXXXXXXXXXXXXXXXXXXXXXXXXXXXXXXXXXXXXXXXXXXXXXXXXX--XXXXXXXXXXXXXX-XXXXXXXXXXXXXXXXXXXXXXXXXXXXXXXXXXXXXXXXXXXXXXXXXXXXXXXXXXXXXXXXXXXXXXXXXXXXXXXXXXXXXX
XXXXXXXXXXXXXXXXXXXXXXXXXXXXXXXXXXXXXXXXXXXXXXXXXXXXXXXXXXXXXXXXXXXXXXXXXXXXXXXXXXXXXXXXXXXXXXXXXXX--XXXXXXXXXXXXXX-XXXXXXXXXXXXXXXXXXXXXXXXXXXXXXXXXXXXXXXXXXXXXXXXXXXXXXXXXXXXXXXXXXXXXXXXXXXXXXXXXXXXXX
