----------------------------------------------------------------------------------------------------------------------------------------------------------------------------------------------------------
----------------------------------------------------------------------------------------------------------------------------------------------------------------------------------------------------------
----------------------------------------------------------------------------------------------------------------------------------------------------------------------------------------------------------
----------------------------------------------------------------------------------------------------------------------------------------------------------------------------------------------------------
----------------------------------------------------------------------------------------------------------------------------------------------------------------------------------------------------------
----------------------------------------------------------------------------------------------------------------------------------------------------------------------------------------------------------
--------------------------------------------------------------S-------------------------------------------------------------------------------------------------------------------------------------------
------------------------------------------------------------------------------------------------------------------------------------------------------------------------------#---------------------------
-------------------------------------------------------------g---------------------------------------------------------------------------------------------------------------##---------------------------
----------------------------------------------------------------------------------------------------------------------------------------------------------------------------###---------------------------
------------#--#----------##--#------tt--------------------S@S-S---------------S--#----------##--#----------SU-----!-S-----------!-S-----------------------------#---------------C------------SU------C-tt
-----------##--##--------###--##-----tt-------------------------------------------##--------###--##-------------------------------------------------------------##--------------------------------------tt
----------###--###------####--###----tt---------------------------XTT-------------###------####--###--------------------XTT-----------XTT----tt-#--tt----------###--------------------------------------tt
-M-------------####----#####--####---tt----------------------------tt--g----####--####----#####--####--g-g---------------tt------------tt----tt##--tt------------------gg-g--------------g-g------------tt
XXXXXXXXXXXXXXXXXXXXXXXXXXXX--XXXXXXXXXXXXXXXXXXXXX--XXXXXXXXXXXXXXXXXXXXXXXXXXXXXXXXXXXXXXXXXX--XXXXXXXXXXXXXXXXXXXXXXXXXXXXXXXXXXXXXXXXXXXXXXXXXXXXXXXXXXXXXXXXXXXXXXXXXX-XXXXXXXXXXXXXXXXXXXX-XXXXXXXXX
XXXXXXXXXXXXXXXXXXXXXXXXXXXX--XXXXXXXXXXXXXXXXXXXXX--XXXX------XXXXXXXXXXXXXXXXXXXXXXXXXXXXXXXX--XXXXXXXXXXXXXXXXXXXXXXXXXXXXXXXXXXXXXXXXXXXXXXXXXXXXXXXXXXXXXXXXXXXXXXXXXX-XXXXXXXXXXXXXXXXXXXX-XXXXXXXXX
