----------------------------------------------------------------------------------------------------------------------------------------------------------------------------------------------------------
----------------------------------------------------------------------------------------------------------------------------------------------------------------------------------------------------------
----------------------------------------------------------------------------------------------------------------------------------------------------------------------------------------------------------
----------------------------------------------------------------------------------------------------------------------------------------------------------------------------------------------------------
----------------------------------------------------------------------------------------------------------------------------------------------------------------------------------------------------------
----------------------------------------------------------------------------------------------------------------------------------------------------------------------------------------------------------
-------------------------------------------------------------------------------------------------------------------------##-------------S-----------------------------------------------------------------
----------------------------------------------------------------------S-------------------------------------------------###-------------------------------------------------------------------------------
-----------------------------------------------------------------------------------------------------------------------####------------g------------------------------------------------------------------
---------------1-----------------------------------------------------------------------------------1------------------#####----------------------------------------1--------------1-----------------------
--------SU-------------------------------#--#-------#-----SS!S---------SU------------!-------------------------------######------!---S@S-S------------C-tt-----------------tt-------------ttSS!S----------
----------------------------------------##--##------##------------------------------------------------tt------------#######-----------------------------tt-----------------tt-------------tt--------------
----------------------------tt-#-------###--###-----###-----------------------------------------------tt--------tt-########-----------------XTT---------tt-----------------tt-------------tt--------------
-M-g-g----------------------tt##-g----####--####----####--------ggg-g---------------------------------tt-g------tt#########------------------tt---------tt-------------g-g-tt---------g-g-tt------gg------
XXXXXXXXXXXXXXXXXXXXXXXXXXXXXXXXXXXXXXXXXXXXXXXXXXX-XXXXXXXXXXXXXXXXXXXXXXXXXXXXXXXXXXXXXXXX--XXXXXXXXXXXXXXXXXXXXXXXXXXXXXXXXXXXXXXXXXXXXXXXXXX-XXXXXXXXXXXXXXXXXXXXXXXXXXXXXXXXXXXXXXXXXXXXXXXXXXXXXXXXX
XXXXXXXXXXXXXXXXXXXXXXXXXXXXXXXXXXXXXXXXXXXXXXXXXXX-XXXXXXXXXXXXXXXXXXXXXXXXXXXXXXXXXXXXXXXX--XXXXXXXXXXXXXXXXXXXXXXXXXXXXXXXXXXXXX------XXXXXXX-XXXXXXXXXXXXXXXXXXXXXXXXXXXXXXXXXXXXXXXXXXXXXXXXXXXXXXXXX
