----------------------------------------------------------------------------------------------------------------------------------------------------------------------------------------------------------
----------------------------------------------------------------------------------------------------------------------------------------------------------------------------------------------------------
----------------------------------------------------------------------------------------------------------------------------------------------------------------------------------------------------------
----------------------------------------------------------------------------------------------------------------------------------------------------------------------------------------------------------
----------------------------------------------------------------------------------------------------------------------------------------------------------------------------------------------------------
-----------------------------------------------------------------------g----------------------------------------------------------------------------------------------------------------------------------
---------------!------S-----------------------------------------------SSSSSSS-----------------------------------------------------------------------------------------------------------------------------
-----------------------------------------#----------------------------------------------------------------------------------------------------------------------------------------------------------------
---------------------g------------------##----------------------------------------------------------------------------------------------------------------------------------------------------------------
---------------------------------------###----------------------------------------------------------------------------------------------------------------------------------------------------------------
-------------S@S!--S@S-S------------C-----SU--------tt-------------#---------------C-tt--------!-------------!-S---------------#--#----------##--#----------!--------------SS!S---------!-S---------------
--------------------------------------------tt------tt------------##-----------------tt---------------------------------------##--##--------###--##-------------------------------------------------------
--------------------------XTT---------------tt------tt-----------###-----------------tt---------------------------XTT--------###--###------####--###-----------------------------------------XTT----tt-#--
-M------------g------------tt--------g-g----tt-g----tt-----g----####-----gg-g--------tt--------k-------------------tt-------------####----#####--####----------------------------gg-----------tt----tt##--
XXXXX--XXXXXXXXXXXXXXXXXXXXXXX-XXXXXXXXXXXXXXXXXXXXXXXXXXXXXXXXXXXXXXXXXXXXXX-XXXXXXXXXXXXXXXXXXXXXXXXXXXXXXXXXXXXXXXXXXXXXXXXXXXXXXXXXXXXXXXXX--XXXXXXXXXXXXXXXXXX--XXXXXXXXXXXXXXXXXXXXXXXXXXXXXXXXXXXXX
XXXXX--XXXX------------XXXXXXX-XXXXXXXXXXXXXXXXXXXXXXXXXXXXXXXXXXXXXXXXXXXXXX-XXXXXXXXXXXXXXXXXXXXXXXXXXXXXXXXXXXXXXXXXXXXXXXXXXXXXXXXXXXXXXXXX--XXXXXXXXXXXXXXXXXX--XXXXXXXXXXXXXXXXXXXXXXXXXXXXXXXXXXXXX
