----------------------------------------------------------------------------------------------------------------------------------------------------------------------------------------------------------
----------------------------------------------------------------------------------------------------------------------------------------------------------------------------------------------------------
----------------------------------------------------------------------------------------------------------------------------------------------------------------------------------------------------------
----------------------------------------------------------------------------------------------------------------------------------------------------------------------------------------------------------
----------------------------------------------------------------------------------------------------------------------------------------------------------------------------------------------------------
------------------------------------------------------g---------------------------------------------------------------------------------------------------------------------------------------------------
----------------------------------------------!------SSSSSSS----------------------------------------------------------------------------------------------------------------------------------------------
----------------------------------------------------------------------------------------------------------------------------------------------------------------------------------------------------------
----------------------------------------------------g---------------------------------------------------------------------------------------------------------------------------------@-------------------
------------S------------------1--------------------------------------------------------------------------------------------------------------------------------------------------------------------------
--------------------tt----------------------S@S!--S@S------------!----------tt-------------S--#----------##--#--------------S--#----------##--#-----------------!--------------------------!-----------#--
--------------------tt------------------------------------------------------tt----------------##--------###--##----------------##--------###--##------------------------------------------------------##--
---#######----------tt------------------------------------------------------tt----------------###------####--###---------------###------####--###------tt-#--------------------#######---------------###--
-M-#######-------gg-tt-----------------------g-------------------k----------tt-----g----####--####----#####--####---g----####--####----#####--####-----tt##--------------------#######-----k---g----####--
XXXXXXXXXXXXXXXXXXXXXXXXXXXXXXXXXXXX--XXXXXXXXXXXXXXXXXXXXX--XXXXXXXXXXXXXXXXXXXXXXXXXXXXXXXXXXXXXXXXXXXXXX--XXXXXXXXXXXXXXXXXXXXXXXXXXXXXXX--XXXXXXXXXXXXXXXXXXXXXXXXX--XXXXXXXXXXXXXXXXXXXXXXXXXXXXXXXXX
XXXXXXXXXXXXXXXXXXXXXXXXXXXXXXXXXXXX--XXXX------------XXXXX--XXXXXXXXXXXXXXXXXXXXXXXXXXXXXXXXXXXXXXXXXXXXXX--XXXXXXXXXXXXXXXXXXXXXXXXXXXXXXX--XXXXXXXXXXXXXXXXXXXXXXXXX--XXXXXXXXXXXXXXXXXXXXXXXXXXXXXXXXX
