----------------------------------------------------------------------------------------------------------------------------------------------------------------------------------------------------------
----------------------------------------------------------------------------------------------------------------------------------------------------------------------------------------------------------
----------------------------------------------------------------------------------------------------------------------------------------------------------------------------------------------------------
----------------------------------------------------------------------------------------------------------------------------------------------------------------------------------------------------------
----------------------------------------------------------------------------------------------------------------------------------------------------------------------------------------------------------
----------------------------------------------------------------------------------------------------------------------------------------------------------------------------------------------------------
---------------------------------------------------------------------------------------------------------------@---------------!------S----!------S------------SSS!------------------------S--------------
----------------------------------------------------------------------------------------------------------------------------------------------------------------------------------------------------------
-------------------------------------------------------------------------------------------------------------------------------------g-----------g----------------------------------------g---------------
----------------------------------------------------------------------------1---------------1-------------------------------------------------------------------------------------------------------------
------------------S----------------------S--#----------##--#-------------------SS!S----------------!--------------SU-----!---S@S!--S@S---S@S!--S@S-S------------------SU------------!---S@S-S-------------
-------------------------tt-----------------##--------###--##---------------------------------------------------------------------------------------------------------------------------------------------
-----tt--------------XTT-tt-----------------###------####--###-------------------------------------------tt-#-----------------------------------------XTT--------------------------------------XTT--------
-M---tt---------------tt-tt-g---------------####----#####--####----------------------gg------------k-----tt##g-g--------------g-----------g------------tt--------g-g----------------------------tt--------
XXXXXXXXXXXX--XXXXXXXXXXXXXXXXXXXXXXXXXXXXXXXXXXXXXXXXXXX--XXXXXXXXXXXXXXXXXXXXXXXXXXXXXXXXXXXXXXXXXXXXXXXXXXXXXXXXXXXXXXXXXXXXXXXXXXXXXXXXXXXXXXXXXXXXXXXXXXXXXXXXXXXXXXXXXXXXXXXXXXXXXXXXXXXXXXXXXXXXXXX
XXXXXXXXXXXX--XXXXXXXXXXXXXXXXXXXXXXXXXXXXXXXXXXXXXXXXXXX--XXXXXXXXXXXXXXXXXXXXXXXXXXXXXXXXXXXXXXXXXXXXXXXXXXXXXXXXXXXXXXXX------------------------XXXXXXXXXXXXXXXXXXXXXXXXXXXXXXXXXXX------XXXXXXXXXXXXXX
