----------------------------------------------------------------------------------------------------------------------------------------------------------------------------------------------------------
----------------------------------------------------------------------------------------------------------------------------------------------------------------------------------------------------------
----------------------------------------------------------------------------------------------------------------------------------------------------------------------------------------------------------
----------------------------------------------------------------------------------------------------------------------------------------------------------------------------------------------------------
-----------------------------------------------------------------------------------##---------------------------------------------------------------------------------------------------------------------
----------------------------------------------------------------------------------###---------------------------------------------------------------------------------------------------------------------
---------------------------------------------------------------------------------####------------------------------------------------------------------------------------------------------------S--------
--------------------------------------------S-----------------------------------#####---------------------------------------------------------------------------------------------------------------------
-------------------------------------------------------------------------------######---------------------------------S!!S----------------------------------------------------------------------g---------
-------------------------------------1----------------------------------------#######---------------------------------------------------------------------------------------------------------------------
---SS!S---------!----------------------------SU--------------------C-------SS!S---------SU-------------C-----tt-----------S--------!-------------------------S--#----------##--#----------!---S@S-S-------
-----------------------------------------------tt------------------------------------------------------------tt-------------------------------------------------##--------###--##-------------------------
----------------------------tt-#---------------tt--------tt-#-------------------------------tt---------------tt#######------------------------------------------###------####--###-------------------XTT--
-M-------gg-----------------tt##--------g-g----tt-g------tt##--------------------ggg-g------tt-----------g-g-tt#######-------gg----k----------------------------####----#####--####-------------------tt--
XXXXXXXXXXXXXXXXXXXXXXX--XXXXXXXXXXXXXXXXXXXXXXXXXXXXXXXXXXXX-XXXXXXXXXXXXXXXXXXXXXXXXXXXXXXXXXXX-XXXXXXXXXXXXXXXXXXXXXXXXXXXXXXXXXXXXXXXXXXXXXXXXXXXXXXXXXXXXXXXXXXXXXXXXXXX--XXXXXXXXXXXXXXXXXXXXXXXXXXX
XXXXXXXXXXXXXXXXXXXXXXX--XXXXXXXXXXXXXXXXXXXXXXXXXXXXXXXXXXXX-XXXXXXXXXXXXXXXXXXXXXXXXXXXXXXXXXXX-XXXXXXXXXXXXXXXXXXXXXXXXXXXXXXXXXXXXXXXXXXXXXXXXXXXXXXXXXXXXXXXXXXXXXXXXXXX--XXXXXXXXXXXXX------XXXXXXXX
