----------------------------------------------------------------------------------------------------------------------------------------------------------------------------------------------------------
----------------------------------------------------------------------------------------------------------------------------------------------------------------------------------------------------------
----------------------------------------------------------------------------------------------------------------------------------------------------------------------------------------------------------
----------------------------------------------------------------------------------------------------------------------------------------------------------------------------------------------------------
----------------------------------------------------------------------------------------------------------------------------------------------------------------------------------------------------------
----------------------------------------------------------------------------------------------------------------------------------------------------------------------------------------------------------
------------------------------------------------------------------------------------------------------------------------------------------------------------S----!----------------------------------------
----------------------------------------------------------------------------------------------------------------------------------------------------------------------------------------------------------
-----------------------------------------------------------------------------------------------------------------------------------------------------------g----------------------------------------------
---------------------------------------------1-----------------------------------------------1----------------------------------------1-------------------------------------------------------------------
----------SS!S---------ttSS!S-----tt---------------------#--#----------##--#----------tt-----------------S--#----------##--#--------------tt---------!---S@S---S@S!-----------------------S---------------
-----------------------tt---------tt--------------------##--##--------###--##---------tt--------------------##--------###--##-------------tt--------------------------------------------------------------
------tt-#-------------tt---------tt-------------------###--###------####--###--------tt--------------------###------####--###------------tt--------------------------------------------------------------
-M----tt##------gg-g-g-tt------gg-tt------------------------####----#####--####---g-g-tt---------g----####--####----#####--####-----------tt--------------------g-----------------g----####-----gg-g------
XXXXXXXXXXXXXXXXXXXXXXXXXXXXXXXXXXXXXXXXXXXXXXXXXXXXXXXXXXXXXXXXXXXXXXXXX--XXXXXXXXXXXXXXXXXXXXXXXXXXXXXXXXXXXXXXXXXXXXXX--XXXXXXXXXXXXXXXXXXXXXXXXXXXXXXXXXXXXXXXXXXXXX--XXXXXXXXXXXXXXXXXXXXXXXXXXXXXXXX
XXXXXXXXXXXXXXXXXXXXXXXXXXXXXXXXXXXXXXXXXXXXXXXXXXXXXXXXXXXXXXXXXXXXXXXXX--XXXXXXXXXXXXXXXXXXXXXXXXXXXXXXXXXXXXXXXXXXXXXX--XXXXXXXXXXXXXXXXXXXXXXXXXXXX------------XXXXX--XXXXXXXXXXXXXXXXXXXXXXXXXXXXXXXX
