----------------------------------------------------------------------------------------------------------------------------------------------------------------------------------------------------------
----------------------------------------------------------------------------------------------------------------------------------------------------------------------------------------------------------
----------------------------------------------------------------------------------------------------------------------------------------------------------------------------------------------------------
----------------------------------------------------------------------------------------------------------------------------------------------------------------------------------------------------------
----------------------------------------------------------------------------------------------------------------------------------------------------------------------------------------------------------
----------------------------------------------------------------------------------------------------------------------------------------------------------------------------------------------------------
--------------------------SSS!----------------------------------------------------------------------------------------------------------------------------------------SSS!--------------------------------
-----------------------------------------------------------------------------------------------------------------------------------------g----------------------------------------------------------------
-----------------@-----------------SSS!-------------------------------------------------------------------------------------------------SSSSSSS-----------------------------------------------------------
---------------------------------------------1------------------------------------------------------------------------------------------------------------------------------------------------------------
-------------------------------C-----------------tt-----------------C-------tt--------!-------------------------#--#----------##--#------------------tt-------------C----!-------!-S--------------------tt
-------------------------------------------------tt----tt-------------------tt-----------tt--------------------##--##--------###--##-----------------tt-----------------------------------------tt------tt
----------#######-tt------------#######----------tt----tt-------------------tt-----------tt-------------------###--###------####--###---#######------tt--tt---------------------------XTT-------tt------tt
-M--------#######-tt-g----------#######----------tt----tt-g-----------------tt--------k--tt-g-----------g----####--####----#####--####--#######--g-g-tt--tt--------------k-------------tt-------tt-g----tt
XXXXXXXXXXXXXXXXXXXXXXXXX-XXXXXXXXXXXXXXXXXXXXXXXXXXXXXXXXXXXX-XXXXXXXXXXXXXXXXXXXXXXXXXXXXXXXXXXXXXXXXXXXXXXXXXXXXXXXXXXXXXXXXX--XXXXXXXXXXXXXXXXXXXXXXXXXXXX-XXXXXXXXXXXXXXXXXXXXXXXXXXXXXXXXXXXXXXXXXXX
XXXXXXXXXXXXXXXXXXXXXXXXX-XXXXXXXXXXXXXXXXXXXXXXXXXXXXXXXXXXXX-XXXXXXXXXXXXXXXXXXXXXXXXXXXXXXXXXXXXXXXXXXXXXXXXXXXXXXXXXXXXXXXXX--XXXXXXXXXXXXXXXXXXXXXXXXXXXX-XXXXXXXXXXXXXXXXXXXXXXXXXXXXXXXXXXXXXXXXXXX
