----------------------------------------------------------------------------------------------------------------------------------------------------------------------------------------------------------
----------------------------------------------------------------------------------------------------------------------------------------------------------------------------------------------------------
----------------------------------------------------------------------------------------------------------------------------------------------------------------------------------------------------------
----------------------------------------------------------------------------------------------------------------------------------------------------------------------------------------------------------
----------------------------------------------------------------------------------------------------------------------------------------------------------------------------------------------------------
---------------------------------g------------------------------------------------------------------------------------------------------------------------------------------------------------------------
--------------------------------SSSSSSS----------------------------------SSS!------------------------------------------------------!------S----!-------------------------SSS!-----------------------------
----------------------------------------------------------------------------------------------------------------------------------------------------------------------------------------------------------
-----------------------------------------------------------------------------------------------------------------------------------------g----------------------------------------------------------------
----------------------------------------------------------------------------------------------------------------------------------------------------------------------------------------------------------
--------------!-----------------tt---------SU------------------------#-------------------------S--#-------#------tt--------------S@S!--S@S---S@S!----------------S--------------SU--------S---------------
--------------------------------tt----------------------------------##---------tt-----------------##------##-----tt---------------------------------------------------------------------------------------
--------------------tt-#--tt----tt------------------#######--------###---------tt-----------------###-----###----tt--------------------------------------------------------------------------XTT----------
-M------------k-----tt##--tt----tt----g-g-----------#######--g----####-----gg-gtt-g---------------####----####---tt---------------g-----------g------------------------gg-gg-g----------------tt----------
XXXXXXXXXXXXXXXXXXXXXXXXXXXXXXXXXXXXXXXXXXXXXXXXXXXXXXXXXXXXXXXXXXXXXXXXXXXXXXXXXXXXXXXXXXXXXXXXXXXXXXXXX-XXXXXXXXXXXXXXX--XXXXXXXXXXXXXXXXXXXXXXXXXXX--XXXXXXXXXXXXXXXXXXXXXXXXXXXX--XXXXXXXXXXXXXXXXXXXX
XXXXXXXXXXXXXXXXXXXXXXXXXXXXXXXXXXXXXXXXXXXXXXXXXXXXXXXXXXXXXXXXXXXXXXXXXXXXXXXXXXXXXXXXXXXXXXXXXXXXXXXXX-XXXXXXXXXXXXXXX--XXXX------------------XXXXX--XXXXXXXXXXXXXXXXXXXXXXXXXXXX--XXXXXXXXXXXXXXXXXXXX
