----------------------------------------------------------------------------------------------------------------------------------------------------------------------------------------------------------
----------------------------------------------------------------------------------------------------------------------------------------------------------------------------------------------------------
----------------------------------------------------------------------------------------------------------------------------------------------------------------------------------------------------------
----------------------------------------------------------------------------------------------------------------------------------------------------------------------------------------------------------
----------------------------------------------------------------------------------------------------------------------------------------------------------------------------------------------------------
----------------------------------------------------------------------------------------------------------------------------------------g---------------------------g-------------------------------------
----------------S----!----------------------------------!------------------------------------------------------------------------------SSSSSSS---------------------SSSSSSS--------------------------------
----------------------------------------------------------------------------------------------------------------------------------------------------------------------------------------------------------
---------------g------------------------------------------------------------------------------------------------------------------------------------------------------------------------------------------
------------------------------------------------------------------------------------------------------------------------------1---------------------------------------------------------------------------
-------------S@S---S@S!S-------------------C----------S@S!S------------C-tt----------------------!--------------------------------tt--------!----------S------------------C----!-------tt-----------------
-------------------------------------------------------------------------tt-------------------------------------------------------tt---------------------------------------------------tt-----------------
--------------------------XTT----tt-#------------------------XTT---------tt-------------------------------------------------------tt----------------------XTT--------------------------tt---tt-#----------
-M------------------g------tt----tt##------------------g------tt---------tt-------------------------------------------------------tt--------k--------------tt------------------k---g-g-tt---tt##----------
XXXXX--XXXXXXXXXXXXXXXXXXXXXXXXXXXXXX-XXXXXXXX--XXXXXXXXXXXXXXXXX-XXXXXXXXXXXXXXXXXXXXXXXXXXXXXXXXXXXXXX--XX--XXXXXXXXX--XXXXXXXXXXXXXXXXXXXXXXXX--XXXXXXXXXXXXXXXXX-XXXXXXXXXXXXXXXXXXXXXXXXXXXXXXXXXXXXX
XXXXX--XXXX------------XXXXXXXXXXXXXX-XXXXXXXX--XXXX------XXXXXXX-XXXXXXXXXXXXXXXXXXXXXXXXXXXXXXXXXXXXXX--XX--XXXXXXXXX--XXXXXXXXXXXXXXXXXXXXXXXX--XXXXXXXXXXXXXXXXX-XXXXXXXXXXXXXXXXXXXXXXXXXXXXXXXXXXXXX
