----------------------------------------------------------------------------------------------------------------------------------------------------------------------------------------------------------
----------------------------------------------------------------------------------------------------------------------------------------------------------------------------------------------------------
----------------------------------------------------------------------------------------------------------------------------------------------------------------------------------------------------------
----------------------------------------------------------------------------------------------------------------------------------------------------------------------------------------------------------
-------------------------------##-------------------------------------------------------------------------------------------------------------------------------------------------------------------------
------------------------------###-------------------------------------------------------------------------------------------------------------------------------------------------------------------------
SS!--------------------------####------------------S---------------------------------------------------------------------------------------------------S-----------------------------------------------S--
----------------------------#####---------------------------------------------------------------------------------------------------------------g-----------------S---------------------------------------
---------------------------######-----------------g------------------------------------------------------------------------SSS!----------------SSSSSSS------------------------------------------------g---
--------------------------#######--------------------------------------1----------------------------------------------------------------------------------------------------------------------------------
--------SU-------------C-----tt-----SU----------S@S-S------------------------------S-----------------S------------------t------------------------------------C-----SU----!--------------SU----------S@S-S-
-----------------------------tt-----------------------------------------------------------------------------------------t---------------------------------------------------------------------------------
-------------tt-#------------tt------------------------XTT----------------------------------------------XTT-------------tt#######----tt-#------#######----------------------------------------------------
-M-g-g-------tt##--------g-g-ttg-g----------------------tt-----------------g----####-----gg-g------------tt---------g-g-tt#######----tt##------#######--------g-g--------k---------g-g--------------------
XXXXXXXXXXXXXXXXX-XXXXXXXXXXXXXXXXXXXXXX--XXXXXXXXXXXXXXXXXXXXXXXXXXXXXXXXXXXXXXXXXXXXXXXXXXXXX--XXXXXXXXXXXXXXXXXXXXXXXXXXXXXXXXXXXXXXXXXXXXXXXXXXXXXX-XXXXXXXXXXXXXXXXXXXXXXXXXXXXXXXXXXXX--XXXXXXXXXXXX
XXXXXXXXXXXXXXXXX-XXXXXXXXXXXXXXXXXXXXXX--XXXX------XXXXXXXXXXXXXXXXXXXXXXXXXXXXXXXXXXXXXXXXXXX--XXXXXXXXXXXXXXXXXXXXXXXXXXXXXXXXXXXXXXXXXXXXXXXXXXXXXX-XXXXXXXXXXXXXXXXXXXXXXXXXXXXXXXXXXXX--XXXX------XX
