----------------------------------------------------------------------------------------------------------------------------------------------------------------------------------------------------------
----------------------------------------------------------------------------------------------------------------------------------------------------------------------------------------------------------
----------------------------------------------------------------------------------------------------------------------------------------------------------------------------------------------------------
----------------------------------------------------------------------------------------------------------------------------------------------------------------------------------------------------------
----------------------------------------------------------------------------------------------------------------------------------------------------------------------------------------------------------
----------------------------------------------------------------------------------------------------------------------------------------------------------------------------------------------------------
----------------##----------------------------------------------------------------------------------------------------------------------------------------------------------------------------------------
---------------###----------------------------------------------------------------------------------------------------------------------------------------------------------------------------------------
--------------####----------------------------------------------------------------------------------------------------------------------------------------------------------------------------------------
--------1----#####------1------------------------------------------------------------------------------------------------------------------------------------1--------------------------------------------
------------######------------------------------S--------------S-----------tt--------tt-----------------------C-------------------------tt--------------------------!------------------#--#----------##--#
-----------#######---------------------------------------------------------tt--------tt-------------------------------tt----------------tt--------------------------------------------##--##--------###--#
-----------#######---------------------------------XTT------------XTT------tt--tt----tt-------------tt-#--------------tt----------------tt----------tt-#-----------------tt----------###--###------####--#
-M---------#######----------------------------------tt-------------tt--g-g-tt--tt----tt-------------tt##--------------tt-g----------g-g-tt----------tt##------------k----tt---------------####----#####--#
XXXXXXXXXXXXXXXXXXXXXXXXXXXXXXXXXXXXXXXXXX--XXXXXXXXXXXXX--XXXXXXXXXXXXXXXXXXXXXXXXXXXXXXXXXXXXXXXXXXXXX-XXXXXXXXXXXXXXXXXXXXXXXXXXXXXXXXXXXXXXXXXXXXXXXXXXXXXXXXXXXXXXXXXXXXXXXXXXXXXXXXXXXXXXXXXXXXXX--X
XXXXXXXXXXXXXXXXXXXXXXXXXXXXXXXXXXXXXXXXXX--XXXXXXXXXXXXX--XXXXXXXXXXXXXXXXXXXXXXXXXXXXXXXXXXXXXXXXXXXXX-XXXXXXXXXXXXXXXXXXXXXXXXXXXXXXXXXXXXXXXXXXXXXXXXXXXXXXXXXXXXXXXXXXXXXXXXXXXXXXXXXXXXXXXXXXXXXX--X
