----------------------------------------------------------------------------------------------------------------------------------------------------------------------------------------------------------
----------------------------------------------------------------------------------------------------------------------------------------------------------------------------------------------------------
----------------------------------------------------------------------------------------------------------------------------------------------------------------------------------------------------------
----------------------------------------------------------------------------------------------------------------------------------------------------------------------------------------------------------
----------------------------------------------------------------------------------------------------------------------------------------------------------------------------------------------------------
----------------------------------------------------------------------------------------------------------------------------------------------------------------------------------------------------------
-----------------------------------------------------------------------------------------------------------------------------------------SSS!-------------------------------------------------------------
---------------------------------------------------------------------------------------------------------------S------------------------------------------------------------------------------------------
----------------------------------------------------------------------------------------------------SSS!------------------SSS!----------------------------------------------------------------------------
---------------------------------------------------------------------------------S------------------------------------------------------------------------------------------------------------------------
--------tt---------#--#----------##--#------------SS!S---------tt------------------------#----------------------SU--------------------------!-----------S--#----------##--#----------------!---tt---------
--------tt--------##--##--------###--##------------------------tt-----------------------##-----------------------------------------------------------------##--------###--##----tt-------------tt---------
--------tt-------###--###------####--###-----------------------tt-------#######--------###---------#######---------------#######---------------------------###------####--###---tt-------------tt---------
-M--g-g-tt-g----####--####----#####--####---------------gg-g-g-tt-------#######----------------gg-g#######-g-g-----------#######------------k---g----####--####----#####--####--tt-g-------k---tt---------
XXXXXXXXXXXXXXXXXXXXXXXXXXXXXXXXXXX--XXXXXXXXXXXXXXXXXXXXXXXXXXXXXXXXXXXXXXXXXXXXXXXXXXXXXXXXXXXXXXXXXXXXXXXXXXXXXXXXXXXXXXXXXXXXXXXXXXXXXXXXXXXXXXXXXXXXXXXXXXXXXXXXXXX--XXXXXXXXXXXXXXXXXXXXXXXXXXXXXXXX
XXXXXXXXXXXXXXXXXXXXXXXXXXXXXXXXXXX--XXXXXXXXXXXXXXXXXXXXXXXXXXXXXXXXXXXXXXXXXXXXXXXXXXXXXXXXXXXXXXXXXXXXXXXXXXXXXXXXXXXXXXXXXXXXXXXXXXXXXXXXXXXXXXXXXXXXXXXXXXXXXXXXXXX--XXXXXXXXXXXXXXXXXXXXXXXXXXXXXXXX
