----------------------------------------------------------------------------------------------------------------------------------------------------------------------------------------------------------
----------------------------------------------------------------------------------------------------------------------------------------------------------------------------------------------------------
----------------------------------------------------------------------------------------------------------------------------------------------------------------------------------------------------------
----------------------------------------------------------------------------------------------------------------------------------------------------------------------------------------------------------
----------------------------------------------------------------------------------------------------------------------------------------------------------------------------------------------------------
----------------------------------------------------------------------------------------------------------------------------------------------------------------------------------------------------------
-------------------------------------------------------SSS!-----------------------------------S-----------SSS!--------------------------------------------------------------------------------------------
----------------------------------------------------------------------------------------------------------------------------------------------------------------------------------------------------------
---------------------------------------------------------------------------------------------g------------------------------------------------------------------------------------------------------------
-----------------------------------1------------------------------------------1-------------------------------------------------1--------------------------------------------------------------------1----
-----------------tt-----------------------!---tt---------tt-----SU-------------------------S@S------------!--------C-------------------!-------SU-------------------------------------#-------------------
-----------------tt---------------------------tt---------tt----------------------------------------------------------------------------------------------------tt--------------------##-------------------
-----------------tt---------------------------tt---------tt---------tt------------------------------------------------------------------------------tt-#-------tt-------tt----------###-------------------
-M---------------tt-----------------------k---tt-----g-g-ttg-g------tt------------------------------------k----------------------------k--g-g-------tt##-------tt-g-----tt------------------gg-g----------
XXXXXXXXXXXXXXXXXXXXXXXXXXXXXXXXXXXXXXXXXXXXXXXXXXXXXXXXXXXXXXXXXXXXXXXXXXXXXXXXXXX--XXXXXXXXXXXXXXX--XXXXXXX-XXXXXXXXXXXXXXXXXXXXXXXXXXXXXXXXXXXXXXXXXXXXXXXXXXXXXXXXXXXXXXXXXXXXXXXXXXXXXXXXXXXXXXXXXX-X
XXXXXXXXXXXXXXXXXXXXXXXXXXXXXXXXXXXXXXXXXXXXXXXXXXXXXXXXXXXXXXXXXXXXXXXXXXXXXXXXXXX--XXXX------XXXXX--XXXXXXX-XXXXXXXXXXXXXXXXXXXXXXXXXXXXXXXXXXXXXXXXXXXXXXXXXXXXXXXXXXXXXXXXXXXXXXXXXXXXXXXXXXXXXXXXXX-X
