----------------------------------------------------------------------------------------------------------------------------------------------------------------------------------------------------------
----------------------------------------------------------------------------------------------------------------------------------------------------------------------------------------------------------
----------------------------------------------------------------------------------------------------------------------------------------------------------------------------------------------------------
----------------------------------------------------------------------------------------------------------------------------------------------------------------------------------------------------------
----------------------------------------------------------------------------------------------------------------------------------------------------------------------------------------------------------
----------------------------------------------------------------------------------------------------g-----------------g-----------------------------------------------------------------------------------
-----------------------------!---------------------------------------------------------------------SSSSSSS-----------SSSSSSS-------------------!------S----!--------------------------------!------S------
----------------------------------------------------------------------------------------------------------------------------------------------------------------------------------------------------------
-----------------------------------------------------------------------------------------------------------------------------------------------------g--------------------------------------------g-------
--------------1-------------------------------------------------------------------------------------------------------------------------------------------------------------------------------------------
---------------------------S@S!S---------------#--#----------##--#--------------#--#----------##--#----------SU-----tt----!--------------!---S@S!--S@S---S@S!-------------------------!---S@S!--S@S-------
----------------------------------------------##--##--------###--##------------##--##--------###--##----------------tt----------------------------------------------tt------------------------------------
----------------------------------XTT--------###--###------####--###----------###--###------####--###---------------tt----------------------------------------------tt------------------------------------
-M--------------------------g------tt--g----####--####----#####--####--------------####----#####--####--g-g-----g-g-tt----k-------------------g-----------g---------tt-g-------------------g--------------
XXXXXXXXXXXXXXXXXXX--XXXXXXXXXXXXXXXXXXXXXXXXXXXXXXXXXXXXXXXXXX--XXXXXXXXXXXXXXXXXXXXXXXXXXXXXXX--XXXXXXXXXXXXXXXXXXXXXXXXXXXXXXXXXXXXXXXXXXXXXXXXXXXXXXXXXXXXXXXX--XXXXXXXXXXXXXXXXXXXXXXXXXXXXXXXXXXXXX-
XXXXXXXXXXXXXXXXXXX--XXXX------XXXXXXXXXXXXXXXXXXXXXXXXXXXXXXXX--XXXXXXXXXXXXXXXXXXXXXXXXXXXXXXX--XXXXXXXXXXXXXXXXXXXXXXXXXXXXXXXXXXXXXXXXX------------------XXXXX--XXXXXXXXXXXXXXXXXXXX------------XXXXX-
