----------------------------------------------------------------------------------------------------------------------------------------------------------------------------------------------------------
----------------------------------------------------------------------------------------------------------------------------------------------------------------------------------------------------------
----------------------------------------------------------------------------------------------------------------------------------------------------------------------------------------------------------
----------------------------------------------------------------------------------------------------------------------------------------------------------------------------------------------------------
----------------------------------------------------------------------------------------------------------------------------------------------------------------------------------------------------------
----------------------------------------------------------------------------------------------------------------------------------------------------------------------------------------------------------
-----------------------------------------------------------------S!!S-------------------------------------------------------------------------------------------------------------------------------------
-------#--------------------------------------------------------------------------------------------------------------------------------------------------------------------------------------------------
------##--------------------------------------------------------------------------------------------------------------------------------------------------------------------------------------------------
-----###--------------------------------------------------------------------------------------------------------------1-----------------------------------------------------------------------------------
--------SU-----------------------#--#-------#----------------tt-----SU------------------------------------S----------------------------SS!S-------------------S---------------------------------------S---
-----------------tt-------------##--##------##---------------tt----------------------------------#--------------------------------------------------------------------------------------------------------
-----------------tt------------###--###-----###--------------tt-----------------------tt-########------------XTT-------------------tt-#------------------------------------------tt-----------------------
-M-g-g-----------tt-g---------------####----####---------g-g-ttg-g--------------------tt#########-------------tt-------------------tt##------gg---------------------gg-g---------tt-----------g----####---
XXXXXXXXXXXXXXXXXXXXXXXXXXXXXXXXXXXXXXXXXXX-XXXXXXXXXXXXXXXXXXXXXXXXXXXXXXXXXXXXXXXXXXXXXXXXXXXXXXXX--XXXXXXXXXXXXXXXXXXXXXXXXXXXXXXXXXXXXXXXXXXXXXXXXXXXXXXXXXXXXXXXXXXXXXXXXXXXXXXXXXXXXXXXXXXXXXXXXXXXX
XXXXXXXXXXXXXXXXXXXXXXXXXXXXXXXXXXXXXXXXXXX-XXXXXXXXXXXXXXXXXXXXXXXXXXXXXXXXXXXXXXXXXXXXXXXXXXXXXXXX--XXXXXXXXXXXXXXXXXXXXXXXXXXXXXXXXXXXXXXXXXXXXXXXXXXXXXXXXXXXXXXXXXXXXXXXXXXXXXXXXXXXXXXXXXXXXXXXXXXXX
