----------------------------------------------------------------------------------------------------------------------------------------------------------------------------------------------------------
----------------------------------------------------------------------------------------------------------------------------------------------------------------------------------------------------------
----------------------------------------------------------------------------------------------------------------------------------------------------------------------------------------------------------
----------------------------------------------------------------------------------------------------------------------------------------------------------------------------------------------------------
----------------------------------------------------------------------------------------------------------------------------------------------------------------------------------------------------------
-----------g----------------------------------------------------------------------------------------------------------------------------------------------------------------------------------------------
----------SSSSSSS-------------------------------------------------##--------------------------------------------------------------------------------------------------------------------------------------
-------------------------------------------S---------------------###--------------------------------------------------------------------------------------------------------------------------------------
----------------------------------------------------------------####--------------------------------------------------------------------------------------------------------------------------------------
---------------------------------------------------------------#####-----------------------------------1--------------------------------------------------------------------------------------------------
---------------!---------------C------------SU-------SS!S-----######------!---------------SS!S-----------------------------------#---------------------tt----------------------------------------!--------
----------------------------------------------tt-------------#######------------------------------------------------------------##---------tt----------tt----------------------tt-------------------------
---#######------------------------------------tt-------------#######-----------------tt-------------------#######--------------###---------tt----------tt#######----tt-#--tt---tt--------tt-#-------------
-M-#######-----k-----------------------g-g----tt-g---------gg#######-----------------tt---------gg--------#######----------------------gg-gtt-g----g-g-tt#######----tt##--tt---tt-g------tt##----k---g----
XXXXXXXXXXXXXXXXXXXXXXXXX-XXXXXXXXXXXXXXXXXXXXXXXXXXXXXXXXXXXXXXXXXXXXXXXXXXXXXXX--XXXXXXXXXXXXXXXXXXXXXXXXXXXXXXXXXXXXXXXXXXXXXXXXXXXXXXXXXXXXXXXXXXXXXXXXXXXXXXXXXXXXXXXXXXXXXXXXXXXXXXXXXXXXXXXXXXXXXXX
XXXXXXXXXXXXXXXXXXXXXXXXX-XXXXXXXXXXXXXXXXXXXXXXXXXXXXXXXXXXXXXXXXXXXXXXXXXXXXXXX--XXXXXXXXXXXXXXXXXXXXXXXXXXXXXXXXXXXXXXXXXXXXXXXXXXXXXXXXXXXXXXXXXXXXXXXXXXXXXXXXXXXXXXXXXXXXXXXXXXXXXXXXXXXXXXXXXXXXXXX
