----------------------------------------------------------------------------------------------------------------------------------------------------------------------------------------------------------
----------------------------------------------------------------------------------------------------------------------------------------------------------------------------------------------------------
----------------------------------------------------------------------------------------------------------------------------------------------------------------------------------------------------------
----------------------------------------------------------------------------------------------------------------------------------------------------------------------------------------------------------
----------------------------------------------------------------------------------------------------------------------------------------------------------------------------------------------------------
-------------------------------------------------------------------g------------------------------------g-------------------------------------------------------------------------------------------------
------------------------------------------------------------------SSSSSSS------------------------------SSSSSSS----------------------------------##---------------------@-------------------------------!--
-----------------------------------------------------------------------------------------------------------------------------------------------###--------------------------------------------------------
----------------------------------------------------------------------------------------------------------------------@-----------------------####--------------------------------------------------------
---------------------------------------------------------------------------------------------------------------------------------------------#####-------------------------------1------------------------
------------S--#-------#----------------------#--#-------#------------------SU---------#--------------!---------------------tt--------------######--#--#-------#----------SU--------SS!S---------!---S@S!-
---------------##------##--------------------##--##------##---------------------------##------------------------------------tt-------------#######-##--##------##-----------------------------------------
---------------###-----###---#######--------###--###-----###-------------------------###-----------------------#######------tt---------tt-#-------###--###-----###----------------------------------------
-M--g----####--####----####--#######--g----####--####----####----------g-g-------------------gg-g--------------#######--g-g-tt---------tt##-g----####--####----####--g-g------------------gg----------g---
XXXXXXXXXXXXXXXXXXXXXX-XXXXXXXXXXXXXXXXXXXXXXXXXXXXXXXXX-XXXXXXXXXXXXXXXXXXXXXXXXXXXXXXXXXXXXXXXXXXXXXXXXXXXX--XXXXXXXXXXXXXXXXXXXXXXXXXXXXXXXXXXXXXXXXXXXXXXX-XXXXXXXXXXXXXXXXXXXXXXXXXXXXXXXXXXXXXXXXXXX
XXXXXXXXXXXXXXXXXXXXXX-XXXXXXXXXXXXXXXXXXXXXXXXXXXXXXXXX-XXXXXXXXXXXXXXXXXXXXXXXXXXXXXXXXXXXXXXXXXXXXXXXXXXXX--XXXXXXXXXXXXXXXXXXXXXXXXXXXXXXXXXXXXXXXXXXXXXXX-XXXXXXXXXXXXXXXXXXXXXXXXXXXXXXXXXXXX------X
