----------------------------------------------------------------------------------------------------------------------------------------------------------------------------------------------------------
----------------------------------------------------------------------------------------------------------------------------------------------------------------------------------------------------------
----------------------------------------------------------------------------------------------------------------------------------------------------------------------------------------------------------
----------------------------------------------------------------------------------------------------------------------------------------------------------------------------------------------------------
----------------------------------------------------------------------------------------------------------------------------------------------------------------------------------------------------------
------------------------------------------------------------------------------------------------------------------------------------------------g---------------------------------------------------------
---------------------------------------------------------S----!------S------------------------------------------------------------------S------SS--SSS!---------------------------------------------------
------------------------------------------------------------------------------------------------------------------------------------------------------------------------------------------------g---------
--------------------------------------------------------g-----------g------------------------------------------------------------------g-------------------------------------------------------SSSSSSS----
------------S---------------------------------------------------------------------------------------------------------------------------------------------------------------------------------------------
----------------!-S--------------------tt---------!---S@S---S@S!--S@S----------------tt-------------------S--------------------------S@S-S----------!-------SU------------C-----!-------------------------
---------------------------------------tt--------------------------------------------tt-------------------------------------------------------------------------------------------------------------------
---#######-----------XTT---------------tt--------------------------------------tt----tt--------------------------------tt-#-----------------XTT-------------------------------------------------#######---
-M-#######------------tt---------------tt--------------------g-----------------tt----tt-------------------------gg-g---tt##------------------tt-----k--g-g--------------------------------------#######---
XXXXXXXXXXXXXXXXXXXXXXXXXXXXXXXXXXXXXXXXXXXXXXXXXXXXXXXXXXXXXXXXXXXXXXXXXXX--XXXXXXXXXXXXXXXXXXXXXXXXXXXXXXXXXXXXXXXXXXXXXXXX--XXXXXXXXXXXXXXXXXXXXXXXXXXXXXXXXXXXXX-XXXXXXXXXXXXXXXXXX--XXXXXXXXXXXXXXXXX
XXXXXXXXXXXXXXXXXXXXXXXXXXXXXXXXXXXXXXXXXXXXXXXXXXXX------------------XXXXX--XXXXXXXXXXXXXXXXXXXXXXXXXXXXXXXXXXXXXXXXXXXXXXXX--XXXX------XXXXXXXXXXXXXXXXXXXXXXXXXXX-XXXXXXXXXXXXXXXXXX--XXXXXXXXXXXXXXXXX
