----------------------------------------------------------------------------------------------------------------------------------------------------------------------------------------------------------
----------------------------------------------------------------------------------------------------------------------------------------------------------------------------------------------------------
----------------------------------------------------------------------------------------------------------------------------------------------------------------------------------------------------------
----------------------------------------------------------------------------------------------------------------------------------------------------------------------------------------------------------
----------------------------------------------------------------------------------------------------------------------------------------------------------------------------------------------------------
----------------------------------------------------------------------------------------------------------------------------------------------------------------------------------------------------------
--------------------------------------------------------------------------------------------------------!-----------------------------------##------------------------------------------------------------
-------------------------------------------------------------------------------------------------------------------------------------------###------------------------------------------------------------
------------------------------------------------------------------------------------------------------------------------------------------####------------------------------------------------------------
--------1-----------------------------------------------------------------------------------------------------------------------------------1---------------------1---------------------------------------
--------------------#--#----------##--#---------------------S--#-------#-----SS!S-----tt--------------S@S!S------SS!S---------tt----------------------------C-----------------------S--------------tt-----
-------------------##--##--------###--##----tt-----------------##------##-------------tt--------------------------------------tt-------------------------------------------------------------------tt-----
------------------###--###------####--###---tt-----------------###-----###------------tt---------------------XTT--------------tt---tt-#------------------------------------------------XTT---------tt-----
-M----------g----####--####----#####--####--tt-g---------------####----####--------gg-tt---------------g------tt-------gg-g-g-tt---tt##-------------------------------------------------tt---------tt-----
XXXXXXXXXXXXXXXXXXXXXXXXXXXXXXXXXXXX--XXXXXXXXXXXXXXXXXXXXXXXXXXXXXXXX-XXXXXXXXXXXXXXXXXXXXXXX--XXXXXXXXXXXXXXXXXXXXXXXXXXXXXXXXXXXXXXXXXXXXXXXXXXXXXX-XXXXXXXXXXXXXXXXXXXXXXX--XXXXXXXXXXXXXXXXXXXXXXXXXX
XXXXXXXXXXXXXXXXXXXXXXXXXXXXXXXXXXXX--XXXXXXXXXXXXXXXXXXXXXXXXXXXXXXXX-XXXXXXXXXXXXXXXXXXXXXXX--XXXX------XXXXXXXXXXXXXXXXXXXXXXXXXXXXXXXXXXXXXXXXXXXX-XXXXXXXXXXXXXXXXXXXXXXX--XXXXXXXXXXXXXXXXXXXXXXXXXX
