----------------------------------------------------------------------------------------------------------------------------------------------------------------------------------------------------------
----------------------------------------------------------------------------------------------------------------------------------------------------------------------------------------------------------
----------------------------------------------------------------------------------------------------------------------------------------------------------------------------------------------------------
----------------------------------------------------------------------------------------------------------------------------------------------------------------------------------------------------------
----------------------------------------------------------------------------------------------------------------------------------------------------------------------------------------------------------
------------------------------------------------------------------------------------------------------------------------------------------------------------------------------------g---------------------
----------------------------!------S----!------------------------------------------------------------------------------------------------------------------------------------S----!SSSSSSS--------------S-
----------------------------------------------------------------------------------------------------------------------------------------------------------------------------------------------------------
----------------------------------g-----------------------------------------------------------------------------------------------------------------------------------------g--------------------------g--
----------------------------------------------------------------------------------------------------------------------------------------------------------------------------------------------------------
-----------tt---------!---S@S!--S@S---S@S!-------------------tt---------#--#----------##--#--------------S--#----------##--#---------!-----------S--------------------!---S@S---S@S!-----------------S@S--
-----------tt------------------------------------------------tt--------##--##--------###--##----------------##--------###--##-----------------------------------------------------------------------------
------tt-#-tt--------------------------------------tt--------tt-------###--###------####--###---------------###------####--###----------------------------------------------------------------------------
-M----tt##-tt--------------g-----------g-----------tt----g-g-tt-g----####--####----#####--####---g----####--####----#####--####------k-----------------gg-g----------------------g------------------------
XXXXXXXXXXXXXXXXXXXXXXXXXXXXXXXXXXXXXXXXXXXXXXX--XXXXXXXXXXXXXXXXXXXXXXXXXXXXXXXXXXXXXXX--XXXXXXXXXXXXXXXXXXXXXXXXXXXXXXX--XXXXXXXXXXXXXXXXXXXXXXXXXXXXXXXXXXXXXXXXXXXXXXXXXXXXXXXXXXXXXX--XX--XXXXXXXXXXX
XXXXXXXXXXXXXXXXXXXXXXXX------------------XXXXX--XXXXXXXXXXXXXXXXXXXXXXXXXXXXXXXXXXXXXXX--XXXXXXXXXXXXXXXXXXXXXXXXXXXXXXX--XXXXXXXXXXXXXXXXXXXXXXXXXXXXXXXXXXXXXXXXXXXXX------------XXXXX--XX--XXXX-------
