----------------------------------------------------------------------------------------------------------------------------------------------------------------------------------------------------------
----------------------------------------------------------------------------------------------------------------------------------------------------------------------------------------------------------
----------------------------------------------------------------------------------------------------------------------------------------------------------------------------------------------------------
----------------------------------------------------------------------------------------------------------------------------------------------------------------------------------------------------------
----------------------------------------------------------------------------------------------------------------------------------------------------------------------------------------------------------
----------------------------------------------------------g-----------------------------------------------------------------------------------------------------------------------------------------------
--------------------------@-----------------------!------SSSSSSS------------------------------------------------------------------------------------------------------------------------------------------
----------------------------------------------------------------------------------------------------------------------------------------------------------------------------------------------------------
--------------------------------------------------------g-------------------------------------------------------------------------------------------------------------------------------------------------
--------1-------------------------------------------------------------------------------------------------------------------------------------------------------------------------------------------------
----------------tt----!--------C-----tt-----!---S@S!--S@S-------------tt------C--------tt---------------------------------S--------------------------C--------------------------!-----------------tt------
----------------tt-------------------tt-------------------------------tt-------tt------tt-----------------------------------------------tt---------------------------tt---------------------------tt------
----------------tt-------------------tt-------------------------------tt-------tt------tt-------------tt---------------------XTT---tt---tt---------------------------tt---------------------tt----tt------
-M----------g-g-tt----k----------g-g-tt----------g----------------g-g-tt-------tt-g----tt-------------tt----------------------tt---tt---tt-g-------------------------tt-g-------k-----------tt----tt------
XXXXXXXXXXXXXXXXXXXXXXXXX-XXXXXXXXXXXXXXXXXXXXXXXXXXXXXXXXXXXXX--XXXXXXX-XXXXXXXXXXXXXXXXXXXXXXXXXXXXXXXXXXXXXXXXXXX--XXXXXXXXXXXXXXXXXXXXXXXXX-XXXXXXXX--XXXXXXXXX--XXXXXXXXXXXXXXXXXXXXXXXXXXXXXXXXXXXXX
XXXXXXXXXXXXXXXXXXXXXXXXX-XXXXXXXXXXXXXXXXXXXX------------XXXXX--XXXXXXX-XXXXXXXXXXXXXXXXXXXXXXXXXXXXXXXXXXXXXXXXXXX--XXXXXXXXXXXXXXXXXXXXXXXXX-XXXXXXXX--XXXXXXXXX--XXXXXXXXXXXXXXXXXXXXXXXXXXXXXXXXXXXXX
