----------------------------------------------------------------------------------------------------------------------------------------------------------------------------------------------------------
----------------------------------------------------------------------------------------------------------------------------------------------------------------------------------------------------------
----------------------------------------------------------------------------------------------------------------------------------------------------------------------------------------------------------
----------------------------------------------------------------------------------------------------------------------------------------------------------------------------------------------------------
----------------------------------------------------------------------------------------------------------------------------------------------------------------------------------------------------------
-----------------------------------------------------------------------------------------g-------------------------g-----------------------------g--------------------------------------------------------
---------------!------------------------------------------------------------------------SSSSSSS-------------------SSSSSSS-----------------------SSSSSSS--------------------!-------------------!----------
----------------------------------------------------------------------------------------------------------------------------------------------------------------------------------------------------------
----------------------------------------------------------------------------------------------------------------------------------------------------------------------------------------------------------
-----------------------------------------------------------------------------------------------------------------------------------S----------------------------------------------------------------------
-------------S@S!-------SS!S-------------------S----------------------------C---------S-------------!-----------S----------------------tt-------------------!------------S@S!------------!---S@S!---------
---------------------------------------------------------------------------------------------------------------------------------------tt-----------------------------------------------------------------
------------------------------------------------------------------tt-#----------------------------------------------------#######------tt-----------------------------------------------------------------
-M------------g---------------gg---------------------gg-g---------tt##--------g----####-----gg-g----k-----------------gg-g#######--g-g-tt-------------------k-------------g-------------------g----------g
XXXXX--XXXXXXXXXXXXXXX--XXXXXXXXXXXXXXXXXXXXXXXXXXXXXXXXXXXXXXXXXXXXXX-XXXXXXXXXXXXXXXXXXXXXXXXXXXXXXXXXXXXXXXXXXXXXXXXXXXXXXXXXXXXXXXXXXXX--XXXXXXXXX--XXXXXXXXX--XXXXXXXXXXXXXXX--XXXXXXXXXXXXXXXXXX--XX
XXXXX--XXXX------XXXXX--XXXXXXXXXXXXXXXXXXXXXXXXXXXXXXXXXXXXXXXXXXXXXX-XXXXXXXXXXXXXXXXXXXXXXXXXXXXXXXXXXXXXXXXXXXXXXXXXXXXXXXXXXXXXXXXXXXX--XXXXXXXXX--XXXXXXXXX--XXXX------XXXXX--XXXXXXX------XXXXX--XX
