----------------------------------------------------------------------------------------------------------------------------------------------------------------------------------------------------------
----------------------------------------------------------------------------------------------------------------------------------------------------------------------------------------------------------
----------------------------------------------------------------------------------------------------------------------------------------------------------------------------------------------------------
----------------------------------------------------------------------------------------------------------------------------------------------------------------------------------------------------------
----------------------------------------------------------------------------------------------------------------------------------------------------------------------------------------------------------
--------------------------------------------------------g-------------------------------------------------------------------------------------------------------------------------------------------------
----------------------##-------------------------------SSSSSSS-------------------------S!!S--------------------------!------------------------------------------------------!------S----------------------
---------------------###----------------------------------------------------------------------------------------------------------------------------------------------------------------------------------
--------------------####------------------------------g---------------------------------------------------------------------------------------------------------------------------g-----------------------
-------------------#####---------------------------------------------------1------------------------------------------------------------------------------------------------------------------------------
--------tt--------######--S--------------tt-----!---S@S-----------------------------C-----SU------------tt-----!---S@S!S------SS!S--------------------#-------------------S@S!--S@S--------------C--------
--------tt-------#######-----------------tt-------------------------------------------------------------tt-------------------------------------------##---------------------------------------------------
--------tt---tt-#------------------------tt----------------------------------------------------tt-#-----tt----------------XTT-----------tt----------###----------------------------------------------tt-#-
-M--g-g-tt---tt##---------------gg-g-g-g-tt------------------------------------------g-g-------tt##-g-g-tt----------g------tt-------gg--tt----g----####-----gg-g-----------g-------------------------tt##-
XXXXXXXXXXXXXXXXXXXXXXXXXXXXXXXXXXXXXXXXXXXXXXXXXXXXXXXXXXXXX--XXXXXXXXXXXXXXX-XXXXXXXXXXXXXXXXXXXXXXXXXXXXXXXXXXXXXXXXXXXXXXXXXXXXXXXXXXXXXXXXXXXXXXXXXXXXXXXXXXX--XXXXXXXXXXXXXXXXXXXXX---XXXXXXXXXXXXXX
XXXXXXXXXXXXXXXXXXXXXXXXXXXXXXXXXXXXXXXXXXXXXXXXXX------XXXXX--XXXXXXXXXXXXXXX-XXXXXXXXXXXXXXXXXXXXXXXXXXXXXXXXXX------XXXXXXXXXXXXXXXXXXXXXXXXXXXXXXXXXXXXXXXXXXX--XXXX------------XXXXX---XXXXXXXXXXXXXX
