----------------------------------------------------------------------------------------------------------------------------------------------------------------------------------------------------------
----------------------------------------------------------------------------------------------------------------------------------------------------------------------------------------------------------
----------------------------------------------------------------------------------------------------------------------------------------------------------------------------------------------------------
----------------------------------------------------------------------------------------------------------------------------------------------------------------------------------------------------------
----------------------------------------------------------------------------------------------------------------------------------------------------------------------------------------------------------
----------------------------------------------------------------------------------------------------------------------------------------------------------------------------------------------------------
----------------------------------------------------------------------------------------------##----------------------------------------------------------------------------------------------------------
---------------------------------------------------------------------------------------------###--------------------g-------------------------------------------------------------------------------------
-------------------------------------------------------------------------------------------------------------------SSSSSSS--------------------------------------------------------------------------------
--------------------------------------------------------------------------------------------------------------------------------------------------------------------1-------------------------------------
------------S--#----------##--#--------------#--#----------##--#----------------------------------------------tt--------------------------------SS!S---------SU---------------------------tt------C-tt----
---------------##--------###--##------------##--##--------###--##-------------------------------tt------------tt-------------------tt-----------------------------------------------------tt--------tt----
---------------###------####--###----------###--###------####--###-------------------tt-#-------tt------------tt----#######----tt-#tt-------------------------------------------tt--------tt--------tt----
-M-------------####----#####--####---g----####--####----#####--####------------------tt##-------tt-g----------tt----#######----tt##tt-g---------------ggg-g---------------------tt----g-g-tt--------tt----
XXXXXXXXXXXXXXXXXXXXXXXXXXXX--XXXXXXXXXXXXXXXXXXXXXXXXXXXXXXX--XXXXXXXXXXXXXXXXXXXXXXXXXXXXXXXXXXXXXXXXXXXXXXXXXXXXXXXXXXXXXXXXXXXXXXXXXXXXXXXXXXXXXXXXXXXXXXXXXXXXXXXXXXXXXXXXXXXXXXXXXXXXX-XXXXXXXXXXXXX
XXXXXXXXXXXXXXXXXXXXXXXXXXXX--XXXXXXXXXXXXXXXXXXXXXXXXXXXXXXX--XXXXXXXXXXXXXXXXXXXXXXXXXXXXXXXXXXXXXXXXXXXXXXXXXXXXXXXXXXXXXXXXXXXXXXXXXXXXXXXXXXXXXXXXXXXXXXXXXXXXXXXXXXXXXXXXXXXXXXXXXXXXX-XXXXXXXXXXXXX
