----------------------------------------------------------------------------------------------------------------------------------------------------------------------------------------------------------
----------------------------------------------------------------------------------------------------------------------------------------------------------------------------------------------------------
----------------------------------------------------------------------------------------------------------------------------------------------------------------------------------------------------------
----------------------------------------------------------------------------------------------------------------------------------------------------------------------------------------------------------
----------------------------------------------------------------------------------------------------------------------------------------------------------------------------------------------------------
---------------------------------------------------g------------------------------------------------------------------------------------------------------------------------------------------------------
--------------------------------------------------SSSSSSS--------------S---------------------------------!------------------------------------------------------------------------------------------------
----------------------------------------------------------------------------------------------------------------------------------------------------------------------------------------------------------
----------------------------------------------------------------------g-----------------------------------------------------------------------------------------------------------------------------------
----------------------------1--------------------------------------------------------------------------------------------------------------------1--------------------------------------------------------
---------------------tt-------------------!------------!------------S@S--------------------------------S@S!S----------------------S--------------------------S--#-------#--------------------------SS!S---
---------------------tt--------tt-------------------------------------------------------------------------------------------------------------------------------##------##----tt------------tt------------
---------------------tt--------tt-------------------------------------------------tt-#--tt--------------------XTT---tt------------------------------------------###-----###---tt------------tt------------
-M---------------g-g-tt--------tt-g-------k------------k--------------------------tt##--tt--------------g------tt---tt------------------gg-g--------------------####----####--tt-g----------tt-g---------g
XXXXXXXXXXXXXXXXXXXXXXXXXXXXXXXXXXXXXXXXXXXXXXXXXXXXXXXXXXXX--XXXXXXXXXXXXXXX--XXXXXXXXXXXXXXXX--XXXXXXXXXXXXXXXXXXXXXXXXXXXXXXXXXXXXXXXXXXXXXXXXXXXXXXXXXXXXXXXXXXXXXX-XXXXXXXXXXXXXXXXXXXXXXXXXXXXXXXXXX
XXXXXXXXXXXXXXXXXXXXXXXXXXXXXXXXXXXXXXXXXXXXXXXXXXXXXXXXXXXX--XXXX------XXXXX--XXXXXXXXXXXXXXXX--XXXX------XXXXXXXXXXXXXXXXXXXXXXXXXXXXXXXXXXXXXXXXXXXXXXXXXXXXXXXXXXXX-XXXXXXXXXXXXXXXXXXXXXXXXXXXXXXXXXX
