----------------------------------------------------------------------------------------------------------------------------------------------------------------------------------------------------------
----------------------------------------------------------------------------------------------------------------------------------------------------------------------------------------------------------
----------------------------------------------------------------------------------------------------------------------------------------------------------------------------------------------------------
----------------------------------------------------------------------------------------------------------------------------------------------------------------------------------------------------------
----------------------------------------------------------------------------------------------------------------------------------------------------------------------------------------------------------
-------------------------------------------------g--------------------------------------------------------------------------------------------------------------------------------------------------------
-----------------------------------------------SSSSSSSS---------------------------------------------------------------------------------------------------------------------------------------------------
----------------------------------------------------------------------------------------------------------------------------------------------------------------------------------------------------------
----------------------------------------------------------------------------------------------------------------------------------------------------------------------------------------------------------
------------------------------------1---------------------------------------------------------------------------------------------------------------------------1-----------------------------------------
---------------!-S--------------------------!-------------SU---------S--------------tt-------------C---------#----------------SS!S------------S----------------------------------SS!S-----------------tt--
------------------------------------------------------------------------------------tt----------------------##----------------------------------------------------------------------------------------tt--
--------------------XTT---tt--------------------------------------------------------tt---tt-#--------------###-----------------------------------XTT------------------tt-#---------------#######------tt##
-M-------------------tt---tt-------------------------g-g-----g----####-----gg-g-g-g-tt---tt##--------g----####-----gg-g-------------gg------------tt------------------tt##-------------gg#######--g-g-tt##
XXXXXXXXXXXXXXXXXXXXXXXXXXXXXXXXXXXXXXXXXXXXXXXXXXX--XXXXXXXXXXXXXXXXXXXXXXXXXXXXXXXXXXXXXXXX-XXXXXXXXXXXXXXXXXXXXXXXXXXXXXXXXXXXXXXXXXX--XXXXXXXXXXXXXXXXXXXXXXXXXXXXXXXXXXXXXXXXXXXXXXXXXXXXXXXXXXXXXXXX
XXXXXXXXXXXXXXXXXXXXXXXXXXXXXXXXXXXXXXXXXXXXXXXXXXX--XXXXXXXXXXXXXXXXXXXXXXXXXXXXXXXXXXXXXXXX-XXXXXXXXXXXXXXXXXXXXXXXXXXXXXXXXXXXXXXXXXX--XXXXXXXXXXXXXXXXXXXXXXXXXXXXXXXXXXXXXXXXXXXXXXXXXXXXXXXXXXXXXXXX
