----------------------------------------------------------------------------------------------------------------------------------------------------------------------------------------------------------
----------------------------------------------------------------------------------------------------------------------------------------------------------------------------------------------------------
----------------------------------------------------------------------------------------------------------------------------------------------------------------------------------------------------------
----------------------------------------------------------------------------------------------------------------------------------------------------------------------------------------------------------
----------------------------------------------------------------------------------------------------------------------------------------------------------------------------------------------------------
-------------------------------------------------------------------------------------------------------------------------g--------------------------------------------------------------------------------
------------------------------------------------------------------------------------------------------------------------SSSSSSS---------------------------------------------------------------------------
----------------------------------------------------------------------------------------------------------------------------------------------------------------------------------------------------------
----------------------------------------------------------------------------------------------------------------------------------------------------------------------------------------------------------
---------------------------------------------------------------------------S------------------------------------------------------------------------------------------------------------------------------
-------!---------SS!S-------------#--#-------#-----SS!S---------SU-----------------#--#----------##--#-----------------------!-----------S--#----------##--#-----------------tt---------------S--#--------
---------------------------------##--##------##-----------------------------------##--##--------###--##-----------tt------------------------##--------###--##----------------tt------------------##-------
------------tt------------------###--###-----###------------------#######--------###--###------####--###----------tt------------------------###------####--###-----tt--------tt------------------###------
-M-----k----tt---------gg------------####----####--------ggg-g----#######--g----####--####----#####--####---------tt-g-------k--------------####----#####--####----tt----g-g-tt-------g----####--####----#
XXXXXXXXXXXXXXXXXXXXXXXXXXXXXXXXXXXXXXXXXXXX-XXXXXXXXXXXXXXXXXXXXXXXXXXXXXXXXXXXXXXXXXXXXXXXXXXXXXX--XXXXXXXXXXXXXXXXXXXXXXXXXXXXXXXXXXXXXXXXXXXXXXXXXXXX--XXXXXXXXXXXXXXXXXXXXXXXXXXXXXXXXXXXXXXXXXXXXXXX
XXXXXXXXXXXXXXXXXXXXXXXXXXXXXXXXXXXXXXXXXXXX-XXXXXXXXXXXXXXXXXXXXXXXXXXXXXXXXXXXXXXXXXXXXXXXXXXXXXX--XXXXXXXXXXXXXXXXXXXXXXXXXXXXXXXXXXXXXXXXXXXXXXXXXXXX--XXXXXXXXXXXXXXXXXXXXXXXXXXXXXXXXXXXXXXXXXXXXXXX
