----------------------------------------------------------------------------------------------------------------------------------------------------------------------------------------------------------
----------------------------------------------------------------------------------------------------------------------------------------------------------------------------------------------------------
----------------------------------------------------------------------------------------------------------------------------------------------------------------------------------------------------------
----------------------------------------------------------------------------------------------------------------------------------------------------------------------------------------------------------
----------------------------------------------------------------------------------------------------------------------------------------------------------------------------------------------------------
----------------------------------------------------------------------------------------------------------------------------------------------------------------------------------------------------------
----------------------------------------------------------------------------------------------------------------------------------------------------------------------------------------------S-----------
--------------------------------------------------------------------------------------------------------------------#-----#-------------------------------------------------------------------------------
----------------------------------------------@--------------------------------------------------------@-----------##----##------------------------------------------------------------------g------------
------------------------------------------------------------------------------------------------------------------###---###--------1----------------------------------------------------------------------
----------SS!S----------SS!S---------tt---------------------SS!S----------------------------------------SS!S---------SU------C----------------------------------!--------SS!S--------------S@S------------
-------------------------------------tt-------------------------------------------tt----------------------------------------------------------------------------------------------------------------------
-------------------------------------tt#######-tt----------------------------tt---tt-------tt---#######----------------------------------tt-#----------tt-#----------------------------------------------t
-M--------------gg------------gg-g-g-tt#######-tt-g---------------gg---------tt---tt-g-----tt---#######-------ggg-g----------------------tt##----------tt##--------------------gg------------------------t
XXXXXXXXXXXXXXXXXXXXXXXXXXXXXXXXXXXXXXXXXXXXXXXXXXXXXXXXXXXXXXXXXXXXXXXXXXXXXXXXXXXXXXXXXXXXXXXXXXXXXXXXXXXXXXXXXXXXXXX-XXXXXXXXXXXXXXXXXXXXXXXXXXXXXXXXXXXXXXXXXXXXXXX--XXXXXXXXXX--XXXXXXXXXXXXXXX--XXXX
XXXXXXXXXXXXXXXXXXXXXXXXXXXXXXXXXXXXXXXXXXXXXXXXXXXXXXXXXXXXXXXXXXXXXXXXXXXXXXXXXXXXXXXXXXXXXXXXXXXXXXXXXXXXXXXXXXXXXXX-XXXXXXXXXXXXXXXXXXXXXXXXXXXXXXXXXXXXXXXXXXXXXXX--XXXXXXXXXX--XXXX------XXXXX--XXXX
