----------------------------------------------------------------------------------------------------------------------------------------------------------------------------------------------------------
----------------------------------------------------------------------------------------------------------------------------------------------------------------------------------------------------------
----------------------------------------------------------------------------------------------------------------------------------------------------------------------------------------------------------
----------------------------------------------------------------------------------------------------------------------------------------------------------------------------------------------------------
-----------------------------------------------------------------------------------------------------------------------------------##---------------------------------------------------------------------
----------------------------------------------------------------------------------------------------------------------------------###---------------------------------------------------------------------
--------------------------------------------------------------------------------------------------------------------------!------####-----------------!---------------------------------------------------
--------------------------------------------g-----------------------------------------------------------------------------------#####---------------------------------------------------------------------
-------------------------------------------SSSSSSS-----------------------------------------------------------------------------######---------------------------------------------------------------------
-----------------------------------------1------------------------------------------------------------------------------------#######--------------------------------------------1------------------------
------------S--------------------!---------------------------S--#----------##--#--------------#-------------------------S@S!------------SU----------S@S!S-----------------tt---------tt-------------------
----------------------tt----------------------------------------##--------###--##------------##---------------------------------------------------------------------------tt---------tt----tt-------------
----------------------tt--------------------#######-------------###------####--###----------###------------------------------------------------------------XTT------------tt---------tt----tt-------tt----
-M--g----####-----gg-gtt-g-------k----------#######-------------####----#####--####-----------------gg-g-----------------g---------g-g---------------g------tt--------g-g-tt---------tt----tt-g-----tt----
XXXXXXXXXXXXXXXXXXXXXXXXXXXXXXXXXXXXXXXXXXXXXXXXXXXXXXXXXXXXXXXXXXXXXXXXXXXXX--XXXXXXXXXXXXXXXXXXXXXXXXXXXXXXXXX--XXXXXXXXXXXXXXX--XXXXXXXXX--XXXXXXXXXXXXXXXXXXXXXXXXXXXXXXXXXXXXXXXXXXXXXXXXXXXXXXXXXXXX
XXXXXXXXXXXXXXXXXXXXXXXXXXXXXXXXXXXXXXXXXXXXXXXXXXXXXXXXXXXXXXXXXXXXXXXXXXXXX--XXXXXXXXXXXXXXXXXXXXXXXXXXXXXXXXX--XXXX------XXXXX--XXXXXXXXX--XXXX------XXXXXXXXXXXXXXXXXXXXXXXXXXXXXXXXXXXXXXXXXXXXXXXXXX
