----------------------------------------------------------------------------------------------------------------------------------------------------------------------------------------------------------
----------------------------------------------------------------------------------------------------------------------------------------------------------------------------------------------------------
----------------------------------------------------------------------------------------------------------------------------------------------------------------------------------------------------------
----------------------------------------------------------------------------------------------------------------------------------------------------------------------------------------------------------
----------------------------------------------------------------------------------------------------------------------------------------------------------------------------------------------------------
----------------------------------------------------------------------------------------------------------------------------------------------------------------------------------------------------------
-----@----------------------!------S----------------------------------!------S-------------------------------------!--------------------!------S----------------------------------------------------------
----------------------------------------------------------------------------------------------------------------------------------------------------------------------------------------------------------
----------------------------------g-----------------------------------------g-----------------------------------------------------------------g-----------------------------------------------------------
-------------------------------------------------------1------------------------------------------------------------------------------------------------------------------1-------------------------------
--------SU----------------S@S!--S@S-S-------------------------------S@S!--S@S-S---------------S--------------!---S@S!S----------------S@S!--S@S-------------------!---------------------------------#--#--
------------------------------------------------------------------------------------------------------------------------------------------------------------------------------------tt-------------##--##-
---------------------------------------XTT---tt----------------------------------XTT------------------------------------XTT---------------------------------------------------------tt------------###--###
-M-g-g---------------------g------------tt---tt----------------------g------------tt--g----####-----gg-g----------g------tt------------g--------------------------k-----------------tt-g---------------###
XXXXXXXXXXXXXXXXXX--XXXXXXXXXXXXXXXXXXXXXXXXXXXXXXXXXXXXXXXX--XXXXXXXXXXXXXXXXXXXXXXXXXXXXXXXXXXXXXXXXXXXXXXXXXXXXXXXXXXXXXXXX--XXXXXXXXXXXXXXXXXXXXX--XXXXXXXXXXXXXXXXXXXXXXXXXXXXXXXXXXXXXXXXXXXXXXXXXXX
XXXXXXXXXXXXXXXXXX--XXXX------------XXXXXXXXXXXXXXXXXXXXXXXX--XXXX------------XXXXXXXXXXXXXXXXXXXXXXXXXXXXXXXXX------XXXXXXXXX--XXXX------------XXXXX--XXXXXXXXXXXXXXXXXXXXXXXXXXXXXXXXXXXXXXXXXXXXXXXXXXX
