----------------------------------------------------------------------------------------------------------------------------------------------------------------------------------------------------------
----------------------------------------------------------------------------------------------------------------------------------------------------------------------------------------------------------
----------------------------------------------------------------------------------------------------------------------------------------------------------------------------------------------------------
----------------------------------------------------------------------------------------------------------------------------------------------------------------------------------------------------------
----------------------------------------------------------------------------------------------------------------------------------------------------------------------------------------------------------
------------------------------------------------------------------------------------------------------------------------------------------g---------------------------------------------------------------
---------------------------------------------!--------SSS!---------------------!--SSS!---------------------------------------------------SSSSSSS----------------------------------SSS!--------------------
----------------------------------------------------------------------------------------------------------------------------------------------------------------------------------------------------------
---------------------------------------------------g------------------------------------------------------------------------------------------------------------------------------------------------------
----------------------------------------------------------------------------------------------------------------------------------------------------------------------------------------------------------
---SS!S-----tt----SS!S---------------------S@S!--S@S-------------tt----------S@S!----------------S--#----------##--#-----------C--------------------SU-------tt----------------!-----------------S--------
------------tt---------------------------------------------------tt---------------------------------##--------###--##----------------------------------------tt-------------------------------------------
------------tt---------------------------------------------------tt---------------------------------###------####--###---------------------------------------tt-------tt-#--------------------------------
-M-------gg-tt----------gg------------------g----------------g-g-tt-----------g----------g----####--####----#####--####------------------------g-g-----------tt-------tt##---------------g----####-----gg-
XXXXXXXXXXXXXXXXXXXXXXXXXXXXXXXXXXX--XXXXXXXXXXXXXXXXXXXXX--XXXXXXXXX--XXXXXXXXXXXXXXX--XXXXXXXXXXXXXXXXXXXXXXXXX--XXXXXX-XXXXXXXX--XXXXXXXXX--XXXXXXXXXXXXXXXXXXXXXXXXXXXXXXXXXXXXXXX--XXXXXXXXXXXXXXXXXX
XXXXXXXXXXXXXXXXXXXXXXXXXXXXXXXXXXX--XXXX------------XXXXX--XXXXXXXXX--XXXX------XXXXX--XXXXXXXXXXXXXXXXXXXXXXXXX--XXXXXX-XXXXXXXX--XXXXXXXXX--XXXXXXXXXXXXXXXXXXXXXXXXXXXXXXXXXXXXXXX--XXXXXXXXXXXXXXXXXX
