----------------------------------------------------------------------------------------------------------------------------------------------------------------------------------------------------------
----------------------------------------------------------------------------------------------------------------------------------------------------------------------------------------------------------
----------------------------------------------------------------------------------------------------------------------------------------------------------------------------------------------------------
----------------------------------------------------------------------------------------------------------------------------------------------------------------------------------------------------------
----------------------------------------------------------------------------------------------------------------------------------------------------------------------------------------------------------
----------------------------------------------------------------------------------------------------------------------------------------------------------------------------------------------------------
-----------------------------------------------------------------------------------------------------------S----!----------------------------------!------S----------------SSS!---------------------------
--------------------------------------------------------------------------g-------------------------------------------------------------------------------------------------------------------------------
-------------------------------------------------------------------------SSSSSSS--------------------------g----------------------------------------------g------------------------------------------------
------------S---------------------------------------------------------------------------------------------------------------------------------------------------------------------------------------------
-------------------S---------------S-----------------tt--------------------------------C----------------S@S---S@S!-------------------------------S@S!--S@S---------------------------!--------------------
-----------------------------------------------------tt---------------------------------------------------------------------------------------------------------------------------------------------------
---#######------------XTT-----------------------tt-#-tt------------------#######-------------------------------------------tt-----------------------------------------------------------#######-----------
-M-#######-------------tt--g----####-----gg-g---tt##-tt------------------#######-------------------------------g-----------tt---------------------g----------------------------------k--#######-----------
XXXXXXXXXXXXX--XXXXXXXXXXXXXXXXXXXXXXXXXXXXXXXXXXXXXXXXXXXXXXXXXXXXXXXXXXXXXXXXXX-XXXXXXXXXXXXXX--XXXXXXXXXXXXXXXXXXXXX--XXXXXXXXXXXXXXXX--XXXXXXXXXXXXXXXXXXXXX--XX--XXXXXXXXX--XXXXXXXXXXXXXXXXXXXXXXXXX
XXXXXXXXXXXXX--XXXXXXXXXXXXXXXXXXXXXXXXXXXXXXXXXXXXXXXXXXXXXXXXXXXXXXXXXXXXXXXXXX-XXXXXXXXXXXXXX--XXXX------------XXXXX--XXXXXXXXXXXXXXXX--XXXX------------XXXXX--XX--XXXXXXXXX--XXXXXXXXXXXXXXXXXXXXXXXXX
