----------------------------------------------------------------------------------------------------------------------------------------------------------------------------------------------------------
----------------------------------------------------------------------------------------------------------------------------------------------------------------------------------------------------------
----------------------------------------------------------------------------------------------------------------------------------------------------------------------------------------------------------
----------------------------------------------------------------------------------------------------------------------------------------------------------------------------------------------------------
----------------------------------------------------------------------------------------------------------------------------------------------------------------------------------------------------------
-------------------------------------------------------------------------g--------------------------------------------------------------------------------------------------------------------------------
------------------------------------------------------------------------SSSSSSS---------------------------------------------------------------------------------!-----------------------------------------
----------------------------------------------------------------------------------------------------------------------------------------------------------------------------------------------------------
---------------------------------------------------------S------------------------------------------------------------------------------------------------------------------------------------------------
----------------------------------------------------------------------1-----------------------------------------------1-----------------------------------------------------------------------------------
---SS!S-----------tt-------------S--#-------#----------------------------------C----!------------------#------------------tt---------tt----------!------------S@S!---------------S------------------tt----
------------------tt----------------##------##--------------------------------------------------------##------------------tt---------tt-------------------------------------------------------------tt----
------------------tt----------------###-----###---#######---tt---------------------------------------###------------------tt---------tt---------------------------------------------XTT---tt--------tt---t
-M-------gg-------tt-----g----####--####----####--#######---tt----------------------k----------g----####-----gg-g---------tt-----g-g-tt----------k-------------g---------------------tt---tt----g-g-tt---t
XXXXXXXXXXXXXXXXXXXXXXXXXXXXXXXXXXXXXXXXXXX-XXXXXXXXXXXXXXXXXXXXXXXXXXXXX-XXXXXXXXXXXXXXXXXXXXXXXXXXXXXXXXXXXXXXXXXXXXXXXXXXXXXXXXXXXXXXXXXXXXXXXXXXXX--XXXXXXXXXXXXXXX--XX--XXXXXXXXXXXXXXXXXXXXXXXXXXXXX
XXXXXXXXXXXXXXXXXXXXXXXXXXXXXXXXXXXXXXXXXXX-XXXXXXXXXXXXXXXXXXXXXXXXXXXXX-XXXXXXXXXXXXXXXXXXXXXXXXXXXXXXXXXXXXXXXXXXXXXXXXXXXXXXXXXXXXXXXXXXXXXXXXXXXX--XXXX------XXXXX--XX--XXXXXXXXXXXXXXXXXXXXXXXXXXXXX
