----------------------------------------------------------------------------------------------------------------------------------------------------------------------------------------------------------
----------------------------------------------------------------------------------------------------------------------------------------------------------------------------------------------------------
----------------------------------------------------------------------------------------------------------------------------------------------------------------------------------------------------------
----------------------------------------------------------------------------------------------------------------------------------------------------------------------------------------------------------
----------------------------------------------------------------------------------------------------------------------------------------------------------------------------------------------------------
--------------------------------------------------------------------------------------------------------------g-------------------------------------------------------------------------------------------
---------------!------S-------------------------------------!------S-----------------------------------------SSSSSSS--------------------------------------------------------------------------------------
----------------------------------------------------------------------------------------------------------------------------------------------------------------------------------------------------------
---------------------g--------------------------------------------g-----------------------------------------g---------------------------------------------------------S!!S--------------------------------
----------------------------------------------------------------------------------------------------------------------------------------------------------------------------------------------------------
-------------S@S!--S@S--------------------------------!---S@S!--S@S-S--------------tt----------C----------S@S------------------------------------C-------------------------------------------S------------
-----------------------------------------------------------------------------------tt---------------------------------------------------------------------------------------------------------------------
---------------------------------------tt-#----------------------------XTT----tt-#-tt--------------------------------------------------tt-#--------------------#######--tt----------------------XTT-------
-M------------g------------------------tt##----------------g------------tt----tt##-tt--------------------------------------------------tt##--------------------#######--tt-----------------------tt-------
XXXXX--XXXXXXXXXXXXXXXXXXXXX--XXXXXXXXXXXXXXXXXXXXXXXXXXXXXXXXXXXXXXXXXXXXXXXXXXXXXXXXXXX-XXXXXXXX--XXXXXXXXXXXXXXX--XX--XXXXXXXXX--XXXXXXX-XXXXXXXXXXXXXXXXXXXXXXXXXXXXXXXXXXXXXXXXXXX--XXXXXXXXXXXXXXXXX
XXXXX--XXXX------------XXXXX--XXXXXXXXXXXXXXXXXXXXXXXXXX------------XXXXXXXXXXXXXXXXXXXXX-XXXXXXXX--XXXX------XXXXX--XX--XXXXXXXXX--XXXXXXX-XXXXXXXXXXXXXXXXXXXXXXXXXXXXXXXXXXXXXXXXXXX--XXXXXXXXXXXXXXXXX
