----------------------------------------------------------------------------------------------------------------------------------------------------------------------------------------------------------
----------------------------------------------------------------------------------------------------------------------------------------------------------------------------------------------------------
----------------------------------------------------------------------------------------------------------------------------------------------------------------------------------------------------------
----------------------------------------------------------------------------------------------------------------------------------------------------------------------------------------------------------
----------------------------------------------------------------------------------------------------------------------------------------------------------------------------------------------------------
--------------------------------------------------g--------------------------------------------------------------------------------------------g----------------------------------------------------------
-----------------------------------S----!------S-SSSSSSS----------------------------------------------------------------S---------------------SSSSSSS-----------------------------------------------------
----------------------------------------------------------------------------------------------------------------------------------------------------------------------------------------------------------
----------------------------------g-----------g------------------------------------------------------------------------g---------------@------------------------------------------------------------------
----------------------------------------------------------------------------------------------------------------------------------------------------------------------------------------------------------
------------#-------------------S@S---S@S!--S@S--------------C---------------S--#----------##--#-----------------!---S@S-S-------------------------!-----------#------------------#-----------------------
-----------##-------------------------------------------------------------------##--------###--##-------------------------------------------------------------##-----------------##-----------------------
----------###-------------------------------------------------------------------###------####--###-----tt-------------------XTT-#######---tt-----------------###----------------###-----------------------
-M--g----####-----gg-g-----------------g----------------------------------------####----#####--####----tt--------------------tt-#######---tt-------k-----------------gg-g-g----####-----gg-g--------------
XXXXXXXXXXXXXXXXXXXXXXXX--XXXXXXXXXXXXXXXXXXXXXXXXXXX---XXXXXXXXXXXXXXXXXXXXXXXXXXXXXXXXXXXXX--XXXXXXXXXXXXXXXXXXXXXXXXXXXXXXXXXXXXXXXXXXXXXXXXXXXXXXXXXXXXXXXXXXXXXXXXXXXXXXXXXXXXXXXXXXXXXXXXXXXXXXXXXXX
XXXXXXXXXXXXXXXXXXXXXXXX--XXXX------------------XXXXX---XXXXXXXXXXXXXXXXXXXXXXXXXXXXXXXXXXXXX--XXXXXXXXXXXXXXXXXXXX------XXXXXXXXXXXXXXXXXXXXXXXXXXXXXXXXXXXXXXXXXXXXXXXXXXXXXXXXXXXXXXXXXXXXXXXXXXXXXXXXX
