----------------------------------------------------------------------------------------------------------------------------------------------------------------------------------------------------------
----------------------------------------------------------------------------------------------------------------------------------------------------------------------------------------------------------
----------------------------------------------------------------------------------------------------------------------------------------------------------------------------------------------------------
----------------------------------------------------------------------------------------------------------------------------------------------------------------------------------------------------------
----------------------------------------------------------------------------------------------------------------------------------------------------------------------------------------------------------
----------------------------------------------------------------------------------------------------------------------------------------------------------------------------------------------------------
---------------S----------------------------------------------!------S----------------S!!S-------------------------------------------------------S--------------------------------------------------------
---------------------------------------------------------------------------------------------------------------------------------#------------------------------------------------------------------------
--------------g-----------------------------------------------------g-----------------------------------------------------------##--------------g---------------------------------------------------------
-------------------------------------------------------------------------------------------------------------------------------###------------------------------------------------------------1-----------
--------!---S@S-S------------------------tt------C----------S@S!--S@S-S------------C-----SU------------!--------------------------SU----------S@S-----------------S--#-------#----------------------------
-----------------------------------------tt--------------------------------------------------------------------------------------------------------------------------##------##---------------------------
-------------------XTT---------tt--------tt------------------------------XTT------------------tt-#-------------------------------------------------------------------###-----###-----------------#######--
-M------------------tt---------tt----g-g-tt------------------g------------tt--------g-g-------tt##---------------------------g-g-------------------------------------####----####----------------#######--
XXXXXXXXXXXXXXXXXXXXXXXXXXXXXXXXXXXXXXXXXXX-XXXXXXXX--XXXXXXXXXXXXXXXXXXXXXXX-XXXXXXXXXXXXXXXXXXXXXXXXXXXXXXXX--XXXXXXXXXXXXXXXXXXXXXX--XXXXXXXXXXXXXXX--XXXXXXXXXXXXXXXXXXX-XXXXXXXXXXXXXXXXXXXXXXXXXXXXX
XXXXXXXXXX------XXXXXXXXXXXXXXXXXXXXXXXXXXX-XXXXXXXX--XXXX------------XXXXXXX-XXXXXXXXXXXXXXXXXXXXXXXXXXXXXXXX--XXXXXXXXXXXXXXXXXXXXXX--XXXX------XXXXX--XXXXXXXXXXXXXXXXXXX-XXXXXXXXXXXXXXXXXXXXXXXXXXXXX
