----------------------------------------------------------------------------------------------------------------------------------------------------------------------------------------------------------
----------------------------------------------------------------------------------------------------------------------------------------------------------------------------------------------------------
----------------------------------------------------------------------------------------------------------------------------------------------------------------------------------------------------------
----------------------------------------------------------------------------------------------------------------------------------------------------------------------------------------------------------
----------------------------------------------------------------------------------------------------------------------------------------------------------------------------------------------------------
------------------------------------------g---------------------------------------------------------------------------------------------------------------------------------------------------------------
-----------------------------------------SSSSSSS------------------------!------S----!---------------------------------------------------------------------------------------------------------------------
----------------------------------------------------------------------------------------------------------------------------------------------------------------------------------------------------------
------------------------------------------------------------------------------g---------------------------------------------------------------------------------------------------------------------------
----------------------------------------------------------------------------------------------------------------------------------------------------------------------------------------------------------
---SS!S-------------------------tt----SS!S---------SU-----------------S@S!--S@S---S@S!----------------S--#-------#--------------#--#----------##--#------------SS!S----------------tt-tt------------------
--------------------------------tt-----------------------------------------------------------------------##------##------------##--##--------###--##-------------------tt----------tt-tt----tt------------
-------------------tt-----------tt----------------------tt-#---------------------------------------------###-----###----------###--###------####--###------------------tt----------tt-tt----tt--------tt-#
-M-------gg--------tt-----------tt----------ggg-g-------tt##-----------g-----------g---------------------####----####---g----####--####----#####--####---------------ggtt-g----g-g-tt-tt----tt-g------tt##
XXXXXXXXXXXXXXXXXXXXXXXXXXXXXXXXXXXXXXXXXXXXXXXXXXXXXXXXXXXXXX--XXXXXXXXXXXXXXXXXXXXXXXXXXX--XXXXXXXXXXXXXXXXXXX-XXXXXXXXXXXXXXXXXXXXXXXXXXXXXXX--XXXXXXXXXXXXXXXXXXXXXXXXXXXXXXXXXXXXXXXXXXXXXXXXXXXXXXXX
XXXXXXXXXXXXXXXXXXXXXXXXXXXXXXXXXXXXXXXXXXXXXXXXXXXXXXXXXXXXXX--XXXX------------------XXXXX--XXXXXXXXXXXXXXXXXXX-XXXXXXXXXXXXXXXXXXXXXXXXXXXXXXX--XXXXXXXXXXXXXXXXXXXXXXXXXXXXXXXXXXXXXXXXXXXXXXXXXXXXXXXX
