----------------------------------------------------------------------------------------------------------------------------------------------------------------------------------------------------------
----------------------------------------------------------------------------------------------------------------------------------------------------------------------------------------------------------
----------------------------------------------------------------------------------------------------------------------------------------------------------------------------------------------------------
----------------------------------------------------------------------------------------------------------------------------------------------------------------------------------------------------------
----------------------------------------------------------------------------------------------------------------------------------------------------------------------------------------------------------
----------------------------------------------------------------------------------------------------------------------------------------------------------------------------------------------------------
---------------S------------------------------------------------------------------------------------------------------------------------------------------------------------------------------------------
------------------------------------------------------------------------------------------------------------------------------------S---------------------------------------------------------------------
--------------g---------------------------------------------------------------------------------------------------------------------------SSS!------------------------------------------------------------
------------------------------------------------------------------------------------------------------------------------------------------------------------------------------------------------------1---
--------!---S@S-S---------------#--#----------##--#---------------------#--#-------#----------tt---------#--#-------#----------------SU--------------------!-----------------------------C----------------
-------------------------------##--##--------###--##-------------------##--##------##---------tt--------##--##------##------------------------------------------------------------------------------------
-------------------XTT--------###--###------####--###------tt-#-------###--###-----###--------tt-------###--###-----###----------------#######-----------------------------------------------tt-#--------#
-M------------------tt-------------####----#####--####-----tt##------------####----####---g-g-tt-g----####--####----####--------g-g----#######-----------------------------------------------tt##--------#
XXXXXXXXXXXXXXXXXXXXXXXXXXXXXXXXXXXXXXXXXXXXXXXX--XXXXXXXXXXXXXXXXXXXXXXXXXXXXXXXX-XXXXXXXXXXXXXXXXXXXXXXXXXXXXXXXX-XXXXXXXXXXXXXXXXXXXXXXXXXXXXXXXXXXXXXXXXXXXXXX--XX--XXXXXXXXX---XXXXXXXXXXXXXXXXXXXXXX
XXXXXXXXXX------XXXXXXXXXXXXXXXXXXXXXXXXXXXXXXXX--XXXXXXXXXXXXXXXXXXXXXXXXXXXXXXXX-XXXXXXXXXXXXXXXXXXXXXXXXXXXXXXXX-XXXXXXXXXXXXXXXXXXXXXXXXXXXXXXXXXXXXXXXXXXXXXX--XX--XXXXXXXXX---XXXXXXXXXXXXXXXXXXXXXX
