----------------------------------------------------------------------------------------------------------------------------------------------------------------------------------------------------------
----------------------------------------------------------------------------------------------------------------------------------------------------------------------------------------------------------
----------------------------------------------------------------------------------------------------------------------------------------------------------------------------------------------------------
----------------------------------------------------------------------------------------------------------------------------------------------------------------------------------------------------------
----------------------------------------------------------------------------------------------------------------------------------------------------------------------------------------------------------
-------------------------g--------------------------------------------------------------------------------------------------------------------------------------------------------------------------------
----------------------##SSSSSSS----------------------------------------------S----!--------------------!--------------------------------------------------------------------------------------------------
---------------------###----------------------------------------------------------------------------------------------------------------------------------------------------------------------------------
--------------------####----------------------------------------------------g-----------------------------------------------------------------------------------------------------------------------------
-------------------#####----------------------------------------------------------------------------------------------------------------------------------------------------------------------------1-----
-------!----------######-----!-----------#--#----------##--#----------!---S@S---S@S!S----------------S@S!----------------#--#----------##--#-------------tt-------------------#--#-------#----------------
-----------------#######----------------##--##--------###--##-----------------------------------------------------------##--##--------###--##------------tt------------------##--##------##---------------
-------------tt-########---------------###--###------####--###-------------------------XTT-----------------------------###--###------####--###-----tt----tt-----------------###--###-----###--------------
-M-----k-----tt#########-----k---g----####--####----#####--####------------------g------tt------------g---------------------####----#####--####----tt----tt-----------g----####--####----####-------------
XXXXXXXXXXXXXXXXXXXXXXXXXXXXXXXXXXXXXXXXXXXXXXXXXXXXXXXXX--XXXXXXXXXXXXXXXXXXXXXXXXXXXXXXXXXX--XXXXXXXXXXXXXXX--XXXXXXXXXXXXXXXXXXXXXXXXX--XXXXXXXXXXXXXXXXXXXXXXXXXXXXXXXXXXXXXXXXXXXXX-XXXXXXXXXXXXXXXXX
XXXXXXXXXXXXXXXXXXXXXXXXXXXXXXXXXXXXXXXXXXXXXXXXXXXXXXXXX--XXXXXXXXXXXXX------------XXXXXXXXX--XXXX------XXXXX--XXXXXXXXXXXXXXXXXXXXXXXXX--XXXXXXXXXXXXXXXXXXXXXXXXXXXXXXXXXXXXXXXXXXXXX-XXXXXXXXXXXXXXXXX
