----------------------------------------------------------------------------------------------------------------------------------------------------------------------------------------------------------
----------------------------------------------------------------------------------------------------------------------------------------------------------------------------------------------------------
----------------------------------------------------------------------------------------------------------------------------------------------------------------------------------------------------------
----------------------------------------------------------------------------------------------------------------------------------------------------------------------------------------------------------
----------------------------------------------------------------------------------------------------------------------------------------------------------------------------------------------------------
----------------------------------------------------------------------------------------------------------------------------------------------------------------------------------------------------------
--------------------------------------------------S!!S------------------------------------------------------------------------------------------------------------------------------S---------------------
----------------------------------------------------------------------------------------------------------------------------------------------------------------------------------------------------------
----------@------------------------------------------------------------------------------------------------------------------------------------------------------------------------g----------------------
---------------------------------------------1--------------1---------------------1------------------------------------------------------1----------------------------------------------------------------
------------------SS!S------------tt-----------------SU------------------------------------------tt---------#--------------------!-----------------------------C-----------------S@S----------------------
----------------------------------tt-------------------------------------------------------------tt--------##-------------------------------------------------------------------------------tt------------
---#######----tt-#-----------tt-#-tt------------------------------------tt--------------tt-#-----tt-------###------------tt-#-------------------------------------tt------------------------tt------------
-M-#######----tt##------gg---tt##-tt------------g-g---------------------tt--------------tt##-g-g-tt---------------gg-g---tt##----k--------------------------------tt------------------------tt-g----------
XXXXXXXXXXXXXXXXXXXXXXXXXXXXXXXXXXXXXXXXXXXXXXXXXXXXXXXXXXXXXXXXXXXXXXXXXXXXXXXXXXXXXXXXXXXXXXXXXXXXXXXXXXXXXXXXXXXXXXXXXXXXXXXXXXXXXXXXXXXXXXXXXXXXXXXXX-XXXXXXXXXXXXXXX--XXXXXXXXXXXXXXX--XXXXXXXXXXXXXX
XXXXXXXXXXXXXXXXXXXXXXXXXXXXXXXXXXXXXXXXXXXXXXXXXXXXXXXXXXXXXXXXXXXXXXXXXXXXXXXXXXXXXXXXXXXXXXXXXXXXXXXXXXXXXXXXXXXXXXXXXXXXXXXXXXXXXXXXXXXXXXXXXXXXXXXXX-XXXXXXXXXXXXXXX--XXXX------XXXXX--XXXXXXXXXXXXXX
