----------------------------------------------------------------------------------------------------------------------------------------------------------------------------------------------------------
----------------------------------------------------------------------------------------------------------------------------------------------------------------------------------------------------------
----------------------------------------------------------------------------------------------------------------------------------------------------------------------------------------------------------
----------------------------------------------------------------------------------------------------------------------------------------------------------------------------------------------------------
----------------------------------------------------------------------------------------------------------------------------------------------------------------------------------------------------------
----------------------------------------------------------------------------------------------------------------------------------------------------------------------------------------------------------
----------------------------------------------------------------------------------S----!------S-------------------S----!---------------------S------------------------------------------------------------
----------------------------------------------------------------------------------------------------------------------------------------------------------------------------------------------------------
---------------------------------------------------------------------------------g-----------g-------------------g--------------------------g-------------------------------------------------------------
----------------------------------------------------------------------------------------------------------------------------------------------------------------------------------------------------------
--------------!-----------#--#-------#--------------S----------tt--------------S@S---S@S!--S@S-------------!---S@S---S@S!S----------------S@S-S-----------!-S-----------tt---------#--#-------#-----------
-------------------------##--##------##------------------------tt-------------------------------------------------------------------------------------------------------tt--------##--##------##----------
------------------------###--###-----###-----------------------tt-----------------------------------------------------------XTT------------------XTT-----------XTT------tt-------###--###-----###---------
-M------------k---g----####--####----####---g----####-----gg-g-tt---------------------g-------------------------------g------tt-------------------tt------------tt--g-g-tt------------####----####--------
XXXXXXXXXXXXXXXXXXXXXXXXXXXXXXXXXXXX-XXXXXXXXXXXXXXXXXXXXXXXXXXXXXXXXXX--XXXXXXXXXXXXXXXXXXXXXXXXXXX--XXXXXXXXXXXXXXXXXXXXXXXXXXXX--XXXXXXXXXXXXXXXXXXXXXXXXXXXXXXXXXXXXXXXXXXXXXXXXXXXXXXXXX-XXXXXXXXXXXX
XXXXXXXXXXXXXXXXXXXXXXXXXXXXXXXXXXXX-XXXXXXXXXXXXXXXXXXXXXXXXXXXXXXXXXX--XXXX------------------XXXXX--XXXXXXX------------XXXXXXXXX--XXXX------XXXXXXXXXXXXXXXXXXXXXXXXXXXXXXXXXXXXXXXXXXXXXXX-XXXXXXXXXXXX
