----------------------------------------------------------------------------------------------------------------------------------------------------------------------------------------------------------
----------------------------------------------------------------------------------------------------------------------------------------------------------------------------------------------------------
----------------------------------------------------------------------------------------------------------------------------------------------------------------------------------------------------------
----------------------------------------------------------------------------------------------------------------------------------------------------------------------------------------------------------
----------------------------------------------------------------------------------------------------------------------------------------------------------------------------------------------------------
------------------------------------------------------------g---------------------------------------------------------------------------------------------------------------------------------------------
-----------------------------------------------------------SSSSSSS---------------------------------------------------------------##-----------------------------------------------------------------------
--------------------------------------------------------------------------------------------------------------------------------###-----------------------------------------------------------------------
-------------------------------------------------------------------------------------------------------------------------------####-----------------------------------------------------------------------
--------1-----------------------------------------------------------------------------------1--------------1------------------#####-----------------------------------------------------------------------
-------------------------------------!-------------tt----------!--------C------------tt-------------tt--------------C--------######---------S-------------------------------------------------------C-----
------------------tt-------------------------------tt--------------------------------tt-------------tt----------------------#######----------------tt-----------------------------------------------------
------------------tt--------tt-#-------------------tt-----------------------tt-#-----tt-------------tt------------------tt-########------------XTT-tt--------tt-#-------#######-----------tt-#------------
-M----------------tt-g------tt##---------------g-g-tt----------k------------tt##-g-g-tt---------g-g-tt------------------tt#########-------------tt-tt-g------tt##-------#######-----------tt##--------g-g-
XXXXXXXXXXXXXXXXXXXXXXXXXXXXXXXXXXXXXXXXXXXX--XXXXXXXXXXXXXXXXXXXX-XXXXXXXXXXXXXXXXXXXXXXXXXXXXXXXXXXXXXXXXXXX-XXXXXXXXXXXXXXXXXXXXXXX--XXXXXXXXXXXXXXXXXXXXXXXXXXXXXXXXXXXXXXXXXXXXXXXXXXXXXX-XXXXXXXXXXX
XXXXXXXXXXXXXXXXXXXXXXXXXXXXXXXXXXXXXXXXXXXX--XXXXXXXXXXXXXXXXXXXX-XXXXXXXXXXXXXXXXXXXXXXXXXXXXXXXXXXXXXXXXXXX-XXXXXXXXXXXXXXXXXXXXXXX--XXXXXXXXXXXXXXXXXXXXXXXXXXXXXXXXXXXXXXXXXXXXXXXXXXXXXX-XXXXXXXXXXX
