----------------------------------------------------------------------------------------------------------------------------------------------------------------------------------------------------------
----------------------------------------------------------------------------------------------------------------------------------------------------------------------------------------------------------
----------------------------------------------------------------------------------------------------------------------------------------------------------------------------------------------------------
----------------------------------------------------------------------------------------------------------------------------------------------------------------------------------------------------------
----------------------------------------------------------------------------------------------------------------------------------------------------------------------------------------------------------
----------------------------------------------------------------------------------------------------------------------------------------------------------------------------------------------------------
-------------------------------------!------------------------------------------------------------------------------!-------------------------------------------------------------------------------------
----------------------------------------------------------------------------------------------------------------------------------------------------------------------------------------------------------
------------------------------------------------------------@------------------------------------------------------------------------------------------------------------S!!S---------------------------S!
---------------------------------------------------------------------------------------------------------------------------------------------------------------------------------------1------------------
----------SS!S---------------------S@S!S----------!-------------S---------------!-------tt------------------------S@S!---------------S-------------SS!S----------------------S----------------!-----------
---tt----------------------------------------------------------------tt-----------------tt----------------------------------------------------------------------------------------------------------------
---tt-------------------------------------XTT--------#######---------tt-----------------tt---tt-#---------------------------------------XTT------------------tt---#######------------------------#######--
-M-tt-g---------gg------------------g------tt-----k--#######-------ggtt-g-------k---g-g-tt---tt##------------------g---------------------tt--------------gg--tt---#######-------gg------------k--#######--
XXXXXXXXXXXXXXXXXXXXXXXXXXX--XXXXXXXXXXXXXXXXXXXXXXXXXXXXXXXXXXXXXXXXXXXXXXXXXXXXXXXXXXXXXXXXXXXXXXXXXXXXX--XXXXXXXXXXXXXXX--XX--XXXXXXXXXXXXXXXXXXXXXXXXXXXXXXXXXXXXXXXXXXXXXXXXXXXXXXXXXXXXXXXXXXXXXXXX-
XXXXXXXXXXXXXXXXXXXXXXXXXXX--XXXX------XXXXXXXXXXXXXXXXXXXXXXXXXXXXXXXXXXXXXXXXXXXXXXXXXXXXXXXXXXXXXXXXXXX--XXXX------XXXXX--XX--XXXXXXXXXXXXXXXXXXXXXXXXXXXXXXXXXXXXXXXXXXXXXXXXXXXXXXXXXXXXXXXXXXXXXXXX-
