----------------------------------------------------------------------------------------------------------------------------------------------------------------------------------------------------------
----------------------------------------------------------------------------------------------------------------------------------------------------------------------------------------------------------
----------------------------------------------------------------------------------------------------------------------------------------------------------------------------------------------------------
----------------------------------------------------------------------------------------------------------------------------------------------------------------------------------------------------------
----------------------------------------------------------------------------------------------------------------------------------------------------------------------------------------------------------
-----------------g----------------------------------------------------------------------------------------------------------------------------------------------------------------------------------------
----------------SSSSSSS------------------------------------------------------------------------------S!!S----------S!!S---SSS!----------------------------@-----------------------------------------------
----------------------------------------------------------------------------------------------------------------------------------------------------------------------------------------------------------
----------------------------------------------------------------------------------------------------------------------------------------------------------------------------------------------------------
----------------------------------------------------------------------------------------------------------------------------------------------------------------------------------------------------------
---------------!--------------C---------------tt---------!-S-----------------------------#--------------SU-tt---------SU-----------SU---------S--------------SU-----tt-----!-S----------------------S--#--
----------------------------------------------tt----------------------------------------##-----------------tt-------------------------------------------------------tt---------------------------------##-
----------------------------------tt-#--tt----tt--------------XTT-#######--------------###-----------------tt-------------------------------------------------------tt----------XTT--------------------###
-M--------------------------------tt##--tt----tt---------------tt-#######----------------------gg-gg-g-----tt----g-g----------g-g-----g----####-----gg-gg-g-----g-g-tt-----------tt--------------------###
XXXXXXXXXXXXXXXXXXXXXX---XXXXXXXXXXXXXXXXXXXXXXXXXXXXXXXXXXXXXXXXXXXXXXXXXXXXXXXXXXXXXXXXXXXXXXXXXXXXXXXXXXXXXXXXXXXXXXXXXXXXXXXXXXXXXXXXXXXXXXXXXXXXXXXXXXXXXXXXXXXXXXXXXXXXXXXXXXXXXXXXXXXXXXXXXXXXXXXXX
XXXXXXXXXXXXXXXXXXXXXX---XXXXXXXXXXXXXXXXXXXXXXXXXXXXXXXXXXXXXXXXXXXXXXXXXXXXXXXXXXXXXXXXXXXXXXXXXXXXXXXXXXXXXXXXXXXXXXXXXXXXXXXXXXXXXXXXXXXXXXXXXXXXXXXXXXXXXXXXXXXXXXXXXXXXXXXXXXXXXXXXXXXXXXXXXXXXXXXXX
