----------------------------------------------------------------------------------------------------------------------------------------------------------------------------------------------------------
----------------------------------------------------------------------------------------------------------------------------------------------------------------------------------------------------------
----------------------------------------------------------------------------------------------------------------------------------------------------------------------------------------------------------
----------------------------------------------------------------------------------------------------------------------------------------------------------------------------------------------------------
----------------------------------------------------------------------------------------------------------------------------------------------------------------------------------------------------------
----------------------------------------------------------------------------------g-----------------------------------------------------------------------------------------------------------------------
---------------------------------------------------------------------------------SSSSSSS----------------------------------------------------------------------SSS!----------------------------------------
--------------------------------------------------------------------------------------------------------------------------------------------------------------------------#-------------------------------
--------------------------------------------------------------------------------g----------------------------------------------------------------------------------------##-------------------------------
-------------------------------------------------------------------------------------------------------------------------------#----------------------------------------###-------------------------------
-------------------------S-------tt-----------SS!S------------S-----------!---S@S--------------C-----!-S------SS!S------------##----------------------S--------------SU------C--------------SS!S-----tt---
---tt----------------------------tt----tt------------------------------------------------------------------------------------###---------------------------------------------------------------------tt---
---tt-----------------------XTT--tt----tt------------------------XTT--------------------------------------XTT---------#######------------------------------------------------------------------------tt---
-M-tt-g----------------------tt--tt----tt-g---------gg------------tt---------------------------------------tt-------gg#######-------gg----------------------gg-gg-g-------------------------------gg-tt---
XXXXXXXXXXXXXXXXXXX--XXXXXXXXXXXXXXXXXXXXXXXXXXXXXXXXXXX--XXXXXXXXXXXXXXXXXXXXXXXXXXXXX---XXXXXXXXXXXXXXXXXXXXXXXXXXXXXXXXXXXXXXXXXXXXXXXXXXXXXXXXXXXXXXXXXXXXXXXXXXXXX-XXXXXXXXXXXXXXXXXXXXXXXXXXXXXXXXXX
XXXXXXXXXXXXXXXXXXX--XXXXXXXXXXXXXXXXXXXXXXXXXXXXXXXXXXX--XXXXXXXXXXXXXXXXXX------XXXXX---XXXXXXXXXXXXXXXXXXXXXXXXXXXXXXXXXXXXXXXXXXXXXXXXXXXXXXXXXXXXXXXXXXXXXXXXXXXXX-XXXXXXXXXXXXXXXXXXXXXXXXXXXXXXXXXX
