----------------------------------------------------------------------------------------------------------------------------------------------------------------------------------------------------------
----------------------------------------------------------------------------------------------------------------------------------------------------------------------------------------------------------
----------------------------------------------------------------------------------------------------------------------------------------------------------------------------------------------------------
----------------------------------------------------------------------------------------------------------------------------------------------------------------------------------------------------------
----------------------------------------------------------------------------------------------------------------------------------------------------------------------------------------------------------
-------------------------------------------------------------------------------------------------------------g--------------------------------------------------------------------------------------------
---------------------------------------------------S----!----------SSS!-------------------------------------SSSSSSS-----------------------------------------SSS!---------------------S----!---------------
----------------------------------------------------------------------------------------------------------------------------------------------------------------------------------------------------------
--------------------------------------------------g---------------------------------------------------------------------------------------------------------------------------------g---------------------
--------------------------------------------------------------------------------------------------------------------------------------------------------------------------------------------------------1-
------------------tt----------C-----------------S@S---S@S!S-----------SU------C-------tt----------------SU-tt---------SU--------tt---------------!---tt--------!--------------!---S@S---S@S!--------------
----------tt------tt-----------tt-----------------------------------------------------tt-------------------tt-------------------tt-------------------tt---------------------------------------------------
----------tt------tt-----------tt----------------------------XTT----------------------tt------tt-----------tt-------------tt----tt-------------------tt-------------tt------------------------------------
-M--------tt-g----tt-----------tt-g--------------------g------tt-g-g------------------tt------tt---g-g-----tt----g-g------tt----tt---------------k---tt--------k----tt-------------------g----------------
XXXXXXXXXXXXXXXXXXXXXXXX-XXXXXXXXXXXXXXX--XXXXXXXXXXXXXXXXXXXXXXXXXXXXXX-XXXXXXXXXXXXXXXXXXXXXXXXXXXXXXXXXXXXXXXXXXXXXXXXXXXXXXXXXXXXXXXXXXXXXXXXXXXXXXXXXXXXXXXXXXXXXXXXXXXXXXXXXXXXXXXXXXXXXXXX--XXXXXXX
XXXXXXXXXXXXXXXXXXXXXXXX-XXXXXXXXXXXXXXX--XXXX------------XXXXXXXXXXXXXX-XXXXXXXXXXXXXXXXXXXXXXXXXXXXXXXXXXXXXXXXXXXXXXXXXXXXXXXXXXXXXXXXXXXXXXXXXXXXXXXXXXXXXXXXXXXXXXXXXXXXXXX------------XXXXX--XXXXXXX
